G:/PycharmProjects/musicgeneration/classificationbyCNN/mirex_test/folder/classical.00091.au	classical
G:/PycharmProjects/musicgeneration/classificationbyCNN/mirex_test/folder/rock.00067.au	rock
G:/PycharmProjects/musicgeneration/classificationbyCNN/mirex_test/folder/pop.00034.au	pop
G:/PycharmProjects/musicgeneration/classificationbyCNN/mirex_test/folder/rock.00059.au	rock
G:/PycharmProjects/musicgeneration/classificationbyCNN/mirex_test/folder/jazz.00031.au	jazz
G:/PycharmProjects/musicgeneration/classificationbyCNN/mirex_test/folder/metal.00008.au	hiphop
G:/PycharmProjects/musicgeneration/classificationbyCNN/mirex_test/folder/classical.00057.au	classical
G:/PycharmProjects/musicgeneration/classificationbyCNN/mirex_test/folder/reggae.00064.au	reggae
G:/PycharmProjects/musicgeneration/classificationbyCNN/mirex_test/folder/jazz.00073.au	jazz
G:/PycharmProjects/musicgeneration/classificationbyCNN/mirex_test/folder/jazz.00070.au	jazz
G:/PycharmProjects/musicgeneration/classificationbyCNN/mirex_test/folder/reggae.00080.au	reggae
G:/PycharmProjects/musicgeneration/classificationbyCNN/mirex_test/folder/reggae.00065.au	reggae
G:/PycharmProjects/musicgeneration/classificationbyCNN/mirex_test/folder/classical.00078.au	classical
G:/PycharmProjects/musicgeneration/classificationbyCNN/mirex_test/folder/hiphop.00036.au	hiphop
G:/PycharmProjects/musicgeneration/classificationbyCNN/mirex_test/folder/metal.00061.au	metal
G:/PycharmProjects/musicgeneration/classificationbyCNN/mirex_test/folder/classical.00093.au	classical
G:/PycharmProjects/musicgeneration/classificationbyCNN/mirex_test/folder/disco.00062.au	disco
G:/PycharmProjects/musicgeneration/classificationbyCNN/mirex_test/folder/metal.00043.au	metal
G:/PycharmProjects/musicgeneration/classificationbyCNN/mirex_test/folder/reggae.00028.au	reggae
G:/PycharmProjects/musicgeneration/classificationbyCNN/mirex_test/folder/reggae.00000.au	reggae
G:/PycharmProjects/musicgeneration/classificationbyCNN/mirex_test/folder/blues.00045.au	blues
G:/PycharmProjects/musicgeneration/classificationbyCNN/mirex_test/folder/country.00067.au	blues
G:/PycharmProjects/musicgeneration/classificationbyCNN/mirex_test/folder/hiphop.00060.au	hiphop
G:/PycharmProjects/musicgeneration/classificationbyCNN/mirex_test/folder/disco.00091.au	disco
G:/PycharmProjects/musicgeneration/classificationbyCNN/mirex_test/folder/blues.00068.au	blues
G:/PycharmProjects/musicgeneration/classificationbyCNN/mirex_test/folder/pop.00072.au	pop
G:/PycharmProjects/musicgeneration/classificationbyCNN/mirex_test/folder/pop.00003.au	pop
G:/PycharmProjects/musicgeneration/classificationbyCNN/mirex_test/folder/disco.00063.au	disco
G:/PycharmProjects/musicgeneration/classificationbyCNN/mirex_test/folder/reggae.00091.au	reggae
G:/PycharmProjects/musicgeneration/classificationbyCNN/mirex_test/folder/jazz.00097.au	jazz
G:/PycharmProjects/musicgeneration/classificationbyCNN/mirex_test/folder/metal.00053.au	metal
G:/PycharmProjects/musicgeneration/classificationbyCNN/mirex_test/folder/blues.00084.au	blues
G:/PycharmProjects/musicgeneration/classificationbyCNN/mirex_test/folder/hiphop.00037.au	reggae
G:/PycharmProjects/musicgeneration/classificationbyCNN/mirex_test/folder/pop.00082.au	disco
G:/PycharmProjects/musicgeneration/classificationbyCNN/mirex_test/folder/reggae.00016.au	disco
G:/PycharmProjects/musicgeneration/classificationbyCNN/mirex_test/folder/classical.00008.au	classical
G:/PycharmProjects/musicgeneration/classificationbyCNN/mirex_test/folder/classical.00030.au	classical
G:/PycharmProjects/musicgeneration/classificationbyCNN/mirex_test/folder/classical.00013.au	classical
G:/PycharmProjects/musicgeneration/classificationbyCNN/mirex_test/folder/blues.00000.au	jazz
G:/PycharmProjects/musicgeneration/classificationbyCNN/mirex_test/folder/disco.00085.au	hiphop
G:/PycharmProjects/musicgeneration/classificationbyCNN/mirex_test/folder/country.00052.au	country
G:/PycharmProjects/musicgeneration/classificationbyCNN/mirex_test/folder/blues.00086.au	blues
G:/PycharmProjects/musicgeneration/classificationbyCNN/mirex_test/folder/classical.00094.au	classical
G:/PycharmProjects/musicgeneration/classificationbyCNN/mirex_test/folder/jazz.00042.au	jazz
G:/PycharmProjects/musicgeneration/classificationbyCNN/mirex_test/folder/classical.00009.au	classical
G:/PycharmProjects/musicgeneration/classificationbyCNN/mirex_test/folder/rock.00053.au	rock
G:/PycharmProjects/musicgeneration/classificationbyCNN/mirex_test/folder/reggae.00074.au	reggae
G:/PycharmProjects/musicgeneration/classificationbyCNN/mirex_test/folder/classical.00088.au	classical
G:/PycharmProjects/musicgeneration/classificationbyCNN/mirex_test/folder/pop.00019.au	pop
G:/PycharmProjects/musicgeneration/classificationbyCNN/mirex_test/folder/metal.00071.au	disco
G:/PycharmProjects/musicgeneration/classificationbyCNN/mirex_test/folder/hiphop.00089.au	hiphop
G:/PycharmProjects/musicgeneration/classificationbyCNN/mirex_test/folder/pop.00010.au	country
G:/PycharmProjects/musicgeneration/classificationbyCNN/mirex_test/folder/metal.00098.au	rock
G:/PycharmProjects/musicgeneration/classificationbyCNN/mirex_test/folder/hiphop.00048.au	hiphop
G:/PycharmProjects/musicgeneration/classificationbyCNN/mirex_test/folder/metal.00013.au	metal
G:/PycharmProjects/musicgeneration/classificationbyCNN/mirex_test/folder/pop.00084.au	pop
G:/PycharmProjects/musicgeneration/classificationbyCNN/mirex_test/folder/jazz.00030.au	jazz
G:/PycharmProjects/musicgeneration/classificationbyCNN/mirex_test/folder/rock.00019.au	rock
G:/PycharmProjects/musicgeneration/classificationbyCNN/mirex_test/folder/metal.00009.au	pop
G:/PycharmProjects/musicgeneration/classificationbyCNN/mirex_test/folder/metal.00022.au	disco
G:/PycharmProjects/musicgeneration/classificationbyCNN/mirex_test/folder/hiphop.00065.au	hiphop
G:/PycharmProjects/musicgeneration/classificationbyCNN/mirex_test/folder/pop.00080.au	pop
G:/PycharmProjects/musicgeneration/classificationbyCNN/mirex_test/folder/rock.00026.au	rock
G:/PycharmProjects/musicgeneration/classificationbyCNN/mirex_test/folder/reggae.00027.au	reggae
G:/PycharmProjects/musicgeneration/classificationbyCNN/mirex_test/folder/pop.00001.au	pop
G:/PycharmProjects/musicgeneration/classificationbyCNN/mirex_test/folder/rock.00052.au	country
G:/PycharmProjects/musicgeneration/classificationbyCNN/mirex_test/folder/disco.00087.au	disco
G:/PycharmProjects/musicgeneration/classificationbyCNN/mirex_test/folder/jazz.00055.au	jazz
G:/PycharmProjects/musicgeneration/classificationbyCNN/mirex_test/folder/rock.00086.au	rock
G:/PycharmProjects/musicgeneration/classificationbyCNN/mirex_test/folder/country.00072.au	country
G:/PycharmProjects/musicgeneration/classificationbyCNN/mirex_test/folder/rock.00027.au	disco
G:/PycharmProjects/musicgeneration/classificationbyCNN/mirex_test/folder/jazz.00066.au	jazz
G:/PycharmProjects/musicgeneration/classificationbyCNN/mirex_test/folder/jazz.00091.au	jazz
G:/PycharmProjects/musicgeneration/classificationbyCNN/mirex_test/folder/metal.00026.au	metal
G:/PycharmProjects/musicgeneration/classificationbyCNN/mirex_test/folder/hiphop.00058.au	hiphop
G:/PycharmProjects/musicgeneration/classificationbyCNN/mirex_test/folder/disco.00027.au	reggae
G:/PycharmProjects/musicgeneration/classificationbyCNN/mirex_test/folder/rock.00025.au	rock
G:/PycharmProjects/musicgeneration/classificationbyCNN/mirex_test/folder/metal.00054.au	metal
G:/PycharmProjects/musicgeneration/classificationbyCNN/mirex_test/folder/hiphop.00025.au	hiphop
G:/PycharmProjects/musicgeneration/classificationbyCNN/mirex_test/folder/classical.00089.au	classical
G:/PycharmProjects/musicgeneration/classificationbyCNN/mirex_test/folder/reggae.00075.au	reggae
G:/PycharmProjects/musicgeneration/classificationbyCNN/mirex_test/folder/rock.00046.au	country
G:/PycharmProjects/musicgeneration/classificationbyCNN/mirex_test/folder/country.00061.au	country
G:/PycharmProjects/musicgeneration/classificationbyCNN/mirex_test/folder/blues.00077.au	disco
G:/PycharmProjects/musicgeneration/classificationbyCNN/mirex_test/folder/rock.00007.au	rock
G:/PycharmProjects/musicgeneration/classificationbyCNN/mirex_test/folder/hiphop.00040.au	pop
G:/PycharmProjects/musicgeneration/classificationbyCNN/mirex_test/folder/rock.00014.au	reggae
G:/PycharmProjects/musicgeneration/classificationbyCNN/mirex_test/folder/disco.00058.au	disco
G:/PycharmProjects/musicgeneration/classificationbyCNN/mirex_test/folder/reggae.00010.au	reggae
G:/PycharmProjects/musicgeneration/classificationbyCNN/mirex_test/folder/country.00014.au	disco
G:/PycharmProjects/musicgeneration/classificationbyCNN/mirex_test/folder/metal.00095.au	metal
G:/PycharmProjects/musicgeneration/classificationbyCNN/mirex_test/folder/blues.00025.au	blues
G:/PycharmProjects/musicgeneration/classificationbyCNN/mirex_test/folder/metal.00005.au	metal
G:/PycharmProjects/musicgeneration/classificationbyCNN/mirex_test/folder/disco.00022.au	disco
G:/PycharmProjects/musicgeneration/classificationbyCNN/mirex_test/folder/reggae.00067.au	country
G:/PycharmProjects/musicgeneration/classificationbyCNN/mirex_test/folder/metal.00064.au	metal
G:/PycharmProjects/musicgeneration/classificationbyCNN/mirex_test/folder/jazz.00099.au	jazz
G:/PycharmProjects/musicgeneration/classificationbyCNN/mirex_test/folder/disco.00073.au	disco
G:/PycharmProjects/musicgeneration/classificationbyCNN/mirex_test/folder/jazz.00027.au	jazz
G:/PycharmProjects/musicgeneration/classificationbyCNN/mirex_test/folder/classical.00000.au	classical
G:/PycharmProjects/musicgeneration/classificationbyCNN/mirex_test/folder/country.00017.au	jazz
G:/PycharmProjects/musicgeneration/classificationbyCNN/mirex_test/folder/metal.00032.au	rock
G:/PycharmProjects/musicgeneration/classificationbyCNN/mirex_test/folder/reggae.00006.au	reggae
G:/PycharmProjects/musicgeneration/classificationbyCNN/mirex_test/folder/metal.00047.au	metal
G:/PycharmProjects/musicgeneration/classificationbyCNN/mirex_test/folder/blues.00073.au	jazz
G:/PycharmProjects/musicgeneration/classificationbyCNN/mirex_test/folder/pop.00078.au	pop
G:/PycharmProjects/musicgeneration/classificationbyCNN/mirex_test/folder/blues.00051.au	blues
G:/PycharmProjects/musicgeneration/classificationbyCNN/mirex_test/folder/classical.00011.au	classical
G:/PycharmProjects/musicgeneration/classificationbyCNN/mirex_test/folder/country.00068.au	country
G:/PycharmProjects/musicgeneration/classificationbyCNN/mirex_test/folder/classical.00020.au	classical
G:/PycharmProjects/musicgeneration/classificationbyCNN/mirex_test/folder/jazz.00037.au	jazz
G:/PycharmProjects/musicgeneration/classificationbyCNN/mirex_test/folder/country.00021.au	country
G:/PycharmProjects/musicgeneration/classificationbyCNN/mirex_test/folder/metal.00041.au	metal
G:/PycharmProjects/musicgeneration/classificationbyCNN/mirex_test/folder/country.00013.au	disco
G:/PycharmProjects/musicgeneration/classificationbyCNN/mirex_test/folder/jazz.00057.au	jazz
G:/PycharmProjects/musicgeneration/classificationbyCNN/mirex_test/folder/classical.00095.au	classical
G:/PycharmProjects/musicgeneration/classificationbyCNN/mirex_test/folder/hiphop.00008.au	hiphop
G:/PycharmProjects/musicgeneration/classificationbyCNN/mirex_test/folder/blues.00044.au	blues
G:/PycharmProjects/musicgeneration/classificationbyCNN/mirex_test/folder/jazz.00081.au	jazz
G:/PycharmProjects/musicgeneration/classificationbyCNN/mirex_test/folder/hiphop.00095.au	metal
G:/PycharmProjects/musicgeneration/classificationbyCNN/mirex_test/folder/rock.00061.au	jazz
G:/PycharmProjects/musicgeneration/classificationbyCNN/mirex_test/folder/metal.00063.au	metal
G:/PycharmProjects/musicgeneration/classificationbyCNN/mirex_test/folder/disco.00008.au	disco
G:/PycharmProjects/musicgeneration/classificationbyCNN/mirex_test/folder/reggae.00095.au	hiphop
G:/PycharmProjects/musicgeneration/classificationbyCNN/mirex_test/folder/jazz.00012.au	jazz
G:/PycharmProjects/musicgeneration/classificationbyCNN/mirex_test/folder/hiphop.00080.au	hiphop
G:/PycharmProjects/musicgeneration/classificationbyCNN/mirex_test/folder/disco.00043.au	disco
G:/PycharmProjects/musicgeneration/classificationbyCNN/mirex_test/folder/reggae.00090.au	reggae
G:/PycharmProjects/musicgeneration/classificationbyCNN/mirex_test/folder/country.00043.au	disco
G:/PycharmProjects/musicgeneration/classificationbyCNN/mirex_test/folder/disco.00032.au	disco
G:/PycharmProjects/musicgeneration/classificationbyCNN/mirex_test/folder/pop.00046.au	pop
G:/PycharmProjects/musicgeneration/classificationbyCNN/mirex_test/folder/disco.00033.au	rock
G:/PycharmProjects/musicgeneration/classificationbyCNN/mirex_test/folder/reggae.00089.au	reggae
G:/PycharmProjects/musicgeneration/classificationbyCNN/mirex_test/folder/blues.00023.au	blues
G:/PycharmProjects/musicgeneration/classificationbyCNN/mirex_test/folder/reggae.00019.au	reggae
G:/PycharmProjects/musicgeneration/classificationbyCNN/mirex_test/folder/pop.00062.au	pop
G:/PycharmProjects/musicgeneration/classificationbyCNN/mirex_test/folder/reggae.00055.au	disco
G:/PycharmProjects/musicgeneration/classificationbyCNN/mirex_test/folder/rock.00080.au	disco
G:/PycharmProjects/musicgeneration/classificationbyCNN/mirex_test/folder/blues.00030.au	blues
G:/PycharmProjects/musicgeneration/classificationbyCNN/mirex_test/folder/disco.00080.au	disco
G:/PycharmProjects/musicgeneration/classificationbyCNN/mirex_test/folder/rock.00004.au	rock
G:/PycharmProjects/musicgeneration/classificationbyCNN/mirex_test/folder/country.00044.au	country
G:/PycharmProjects/musicgeneration/classificationbyCNN/mirex_test/folder/reggae.00086.au	metal
G:/PycharmProjects/musicgeneration/classificationbyCNN/mirex_test/folder/country.00097.au	country
G:/PycharmProjects/musicgeneration/classificationbyCNN/mirex_test/folder/jazz.00067.au	jazz
G:/PycharmProjects/musicgeneration/classificationbyCNN/mirex_test/folder/metal.00084.au	pop
G:/PycharmProjects/musicgeneration/classificationbyCNN/mirex_test/folder/jazz.00045.au	jazz
G:/PycharmProjects/musicgeneration/classificationbyCNN/mirex_test/folder/disco.00049.au	disco
G:/PycharmProjects/musicgeneration/classificationbyCNN/mirex_test/folder/country.00038.au	disco
G:/PycharmProjects/musicgeneration/classificationbyCNN/mirex_test/folder/rock.00068.au	rock
G:/PycharmProjects/musicgeneration/classificationbyCNN/mirex_test/folder/country.00078.au	blues
G:/PycharmProjects/musicgeneration/classificationbyCNN/mirex_test/folder/disco.00048.au	rock
G:/PycharmProjects/musicgeneration/classificationbyCNN/mirex_test/folder/rock.00099.au	rock
G:/PycharmProjects/musicgeneration/classificationbyCNN/mirex_test/folder/classical.00004.au	classical
G:/PycharmProjects/musicgeneration/classificationbyCNN/mirex_test/folder/pop.00005.au	rock
G:/PycharmProjects/musicgeneration/classificationbyCNN/mirex_test/folder/disco.00075.au	disco
G:/PycharmProjects/musicgeneration/classificationbyCNN/mirex_test/folder/classical.00069.au	classical
G:/PycharmProjects/musicgeneration/classificationbyCNN/mirex_test/folder/classical.00048.au	classical
G:/PycharmProjects/musicgeneration/classificationbyCNN/mirex_test/folder/hiphop.00051.au	hiphop
G:/PycharmProjects/musicgeneration/classificationbyCNN/mirex_test/folder/pop.00068.au	pop
G:/PycharmProjects/musicgeneration/classificationbyCNN/mirex_test/folder/hiphop.00004.au	pop
G:/PycharmProjects/musicgeneration/classificationbyCNN/mirex_test/folder/jazz.00075.au	jazz
G:/PycharmProjects/musicgeneration/classificationbyCNN/mirex_test/folder/metal.00067.au	metal
G:/PycharmProjects/musicgeneration/classificationbyCNN/mirex_test/folder/hiphop.00057.au	hiphop
G:/PycharmProjects/musicgeneration/classificationbyCNN/mirex_test/folder/pop.00097.au	pop
G:/PycharmProjects/musicgeneration/classificationbyCNN/mirex_test/folder/hiphop.00086.au	hiphop
G:/PycharmProjects/musicgeneration/classificationbyCNN/mirex_test/folder/hiphop.00079.au	hiphop
G:/PycharmProjects/musicgeneration/classificationbyCNN/mirex_test/folder/blues.00008.au	reggae
G:/PycharmProjects/musicgeneration/classificationbyCNN/mirex_test/folder/hiphop.00007.au	hiphop
G:/PycharmProjects/musicgeneration/classificationbyCNN/mirex_test/folder/country.00025.au	country
G:/PycharmProjects/musicgeneration/classificationbyCNN/mirex_test/folder/country.00054.au	country
G:/PycharmProjects/musicgeneration/classificationbyCNN/mirex_test/folder/jazz.00098.au	jazz
G:/PycharmProjects/musicgeneration/classificationbyCNN/mirex_test/folder/country.00034.au	reggae
G:/PycharmProjects/musicgeneration/classificationbyCNN/mirex_test/folder/country.00099.au	rock
G:/PycharmProjects/musicgeneration/classificationbyCNN/mirex_test/folder/jazz.00076.au	jazz
G:/PycharmProjects/musicgeneration/classificationbyCNN/mirex_test/folder/jazz.00093.au	jazz
G:/PycharmProjects/musicgeneration/classificationbyCNN/mirex_test/folder/rock.00035.au	rock
G:/PycharmProjects/musicgeneration/classificationbyCNN/mirex_test/folder/pop.00063.au	country
G:/PycharmProjects/musicgeneration/classificationbyCNN/mirex_test/folder/disco.00064.au	disco
G:/PycharmProjects/musicgeneration/classificationbyCNN/mirex_test/folder/hiphop.00070.au	hiphop
G:/PycharmProjects/musicgeneration/classificationbyCNN/mirex_test/folder/rock.00028.au	metal
G:/PycharmProjects/musicgeneration/classificationbyCNN/mirex_test/folder/classical.00061.au	classical
G:/PycharmProjects/musicgeneration/classificationbyCNN/mirex_test/folder/metal.00018.au	metal
G:/PycharmProjects/musicgeneration/classificationbyCNN/mirex_test/folder/country.00032.au	blues
G:/PycharmProjects/musicgeneration/classificationbyCNN/mirex_test/folder/hiphop.00038.au	hiphop
G:/PycharmProjects/musicgeneration/classificationbyCNN/mirex_test/folder/jazz.00003.au	classical
G:/PycharmProjects/musicgeneration/classificationbyCNN/mirex_test/folder/pop.00064.au	disco
G:/PycharmProjects/musicgeneration/classificationbyCNN/mirex_test/folder/blues.00026.au	blues
G:/PycharmProjects/musicgeneration/classificationbyCNN/mirex_test/folder/classical.00086.au	classical
G:/PycharmProjects/musicgeneration/classificationbyCNN/mirex_test/folder/hiphop.00077.au	hiphop
G:/PycharmProjects/musicgeneration/classificationbyCNN/mirex_test/folder/pop.00036.au	pop
G:/PycharmProjects/musicgeneration/classificationbyCNN/mirex_test/folder/disco.00055.au	disco
G:/PycharmProjects/musicgeneration/classificationbyCNN/mirex_test/folder/classical.00097.au	classical
G:/PycharmProjects/musicgeneration/classificationbyCNN/mirex_test/folder/disco.00069.au	blues
G:/PycharmProjects/musicgeneration/classificationbyCNN/mirex_test/folder/blues.00087.au	blues
G:/PycharmProjects/musicgeneration/classificationbyCNN/mirex_test/folder/rock.00090.au	blues
G:/PycharmProjects/musicgeneration/classificationbyCNN/mirex_test/folder/classical.00071.au	classical
G:/PycharmProjects/musicgeneration/classificationbyCNN/mirex_test/folder/blues.00058.au	country
G:/PycharmProjects/musicgeneration/classificationbyCNN/mirex_test/folder/pop.00038.au	pop
G:/PycharmProjects/musicgeneration/classificationbyCNN/mirex_test/folder/metal.00090.au	metal
G:/PycharmProjects/musicgeneration/classificationbyCNN/mirex_test/folder/jazz.00029.au	jazz
G:/PycharmProjects/musicgeneration/classificationbyCNN/mirex_test/folder/pop.00086.au	pop
G:/PycharmProjects/musicgeneration/classificationbyCNN/mirex_test/folder/jazz.00019.au	jazz
G:/PycharmProjects/musicgeneration/classificationbyCNN/mirex_test/folder/blues.00088.au	blues
G:/PycharmProjects/musicgeneration/classificationbyCNN/mirex_test/folder/metal.00039.au	metal
G:/PycharmProjects/musicgeneration/classificationbyCNN/mirex_test/folder/disco.00028.au	disco
G:/PycharmProjects/musicgeneration/classificationbyCNN/mirex_test/folder/country.00001.au	country
G:/PycharmProjects/musicgeneration/classificationbyCNN/mirex_test/folder/reggae.00005.au	reggae
G:/PycharmProjects/musicgeneration/classificationbyCNN/mirex_test/folder/reggae.00093.au	reggae
G:/PycharmProjects/musicgeneration/classificationbyCNN/mirex_test/folder/blues.00079.au	blues
G:/PycharmProjects/musicgeneration/classificationbyCNN/mirex_test/folder/reggae.00070.au	reggae
G:/PycharmProjects/musicgeneration/classificationbyCNN/mirex_test/folder/blues.00007.au	blues
G:/PycharmProjects/musicgeneration/classificationbyCNN/mirex_test/folder/country.00058.au	country
G:/PycharmProjects/musicgeneration/classificationbyCNN/mirex_test/folder/blues.00002.au	blues
G:/PycharmProjects/musicgeneration/classificationbyCNN/mirex_test/folder/blues.00078.au	blues
G:/PycharmProjects/musicgeneration/classificationbyCNN/mirex_test/folder/disco.00025.au	disco
G:/PycharmProjects/musicgeneration/classificationbyCNN/mirex_test/folder/hiphop.00012.au	hiphop
G:/PycharmProjects/musicgeneration/classificationbyCNN/mirex_test/folder/rock.00060.au	rock
G:/PycharmProjects/musicgeneration/classificationbyCNN/mirex_test/folder/metal.00038.au	metal
G:/PycharmProjects/musicgeneration/classificationbyCNN/mirex_test/folder/classical.00065.au	classical
G:/PycharmProjects/musicgeneration/classificationbyCNN/mirex_test/folder/reggae.00043.au	reggae
G:/PycharmProjects/musicgeneration/classificationbyCNN/mirex_test/folder/hiphop.00069.au	hiphop
G:/PycharmProjects/musicgeneration/classificationbyCNN/mirex_test/folder/rock.00072.au	country
G:/PycharmProjects/musicgeneration/classificationbyCNN/mirex_test/folder/blues.00061.au	blues
G:/PycharmProjects/musicgeneration/classificationbyCNN/mirex_test/folder/blues.00091.au	blues
G:/PycharmProjects/musicgeneration/classificationbyCNN/mirex_test/folder/pop.00089.au	pop
G:/PycharmProjects/musicgeneration/classificationbyCNN/mirex_test/folder/disco.00017.au	disco
G:/PycharmProjects/musicgeneration/classificationbyCNN/mirex_test/folder/rock.00079.au	rock
G:/PycharmProjects/musicgeneration/classificationbyCNN/mirex_test/folder/hiphop.00075.au	hiphop
G:/PycharmProjects/musicgeneration/classificationbyCNN/mirex_test/folder/blues.00028.au	blues
G:/PycharmProjects/musicgeneration/classificationbyCNN/mirex_test/folder/rock.00042.au	rock
G:/PycharmProjects/musicgeneration/classificationbyCNN/mirex_test/folder/rock.00065.au	rock
G:/PycharmProjects/musicgeneration/classificationbyCNN/mirex_test/folder/country.00023.au	rock
G:/PycharmProjects/musicgeneration/classificationbyCNN/mirex_test/folder/pop.00042.au	pop
G:/PycharmProjects/musicgeneration/classificationbyCNN/mirex_test/folder/pop.00075.au	pop
G:/PycharmProjects/musicgeneration/classificationbyCNN/mirex_test/folder/jazz.00058.au	jazz
G:/PycharmProjects/musicgeneration/classificationbyCNN/mirex_test/folder/country.00005.au	disco
G:/PycharmProjects/musicgeneration/classificationbyCNN/mirex_test/folder/classical.00076.au	classical
G:/PycharmProjects/musicgeneration/classificationbyCNN/mirex_test/folder/classical.00064.au	classical
G:/PycharmProjects/musicgeneration/classificationbyCNN/mirex_test/folder/reggae.00051.au	reggae
G:/PycharmProjects/musicgeneration/classificationbyCNN/mirex_test/folder/country.00069.au	jazz
G:/PycharmProjects/musicgeneration/classificationbyCNN/mirex_test/folder/disco.00029.au	disco
G:/PycharmProjects/musicgeneration/classificationbyCNN/mirex_test/folder/hiphop.00002.au	hiphop
G:/PycharmProjects/musicgeneration/classificationbyCNN/mirex_test/folder/disco.00097.au	disco
G:/PycharmProjects/musicgeneration/classificationbyCNN/mirex_test/folder/country.00091.au	country
G:/PycharmProjects/musicgeneration/classificationbyCNN/mirex_test/folder/pop.00012.au	country
G:/PycharmProjects/musicgeneration/classificationbyCNN/mirex_test/folder/metal.00027.au	metal
G:/PycharmProjects/musicgeneration/classificationbyCNN/mirex_test/folder/pop.00061.au	pop
G:/PycharmProjects/musicgeneration/classificationbyCNN/mirex_test/folder/blues.00081.au	blues
G:/PycharmProjects/musicgeneration/classificationbyCNN/mirex_test/folder/reggae.00053.au	reggae
