G:/PycharmProjects/musicgeneration/classificationbyCNN/mirex_test/folder/jazz.00024.au	jazz
G:/PycharmProjects/musicgeneration/classificationbyCNN/mirex_test/folder/rock.00073.au	rock
G:/PycharmProjects/musicgeneration/classificationbyCNN/mirex_test/folder/classical.00017.au	classical
G:/PycharmProjects/musicgeneration/classificationbyCNN/mirex_test/folder/classical.00058.au	classical
G:/PycharmProjects/musicgeneration/classificationbyCNN/mirex_test/folder/metal.00011.au	metal
G:/PycharmProjects/musicgeneration/classificationbyCNN/mirex_test/folder/metal.00075.au	metal
G:/PycharmProjects/musicgeneration/classificationbyCNN/mirex_test/folder/classical.00003.au	classical
G:/PycharmProjects/musicgeneration/classificationbyCNN/mirex_test/folder/pop.00006.au	pop
G:/PycharmProjects/musicgeneration/classificationbyCNN/mirex_test/folder/reggae.00030.au	reggae
G:/PycharmProjects/musicgeneration/classificationbyCNN/mirex_test/folder/rock.00044.au	rock
G:/PycharmProjects/musicgeneration/classificationbyCNN/mirex_test/folder/reggae.00011.au	reggae
G:/PycharmProjects/musicgeneration/classificationbyCNN/mirex_test/folder/disco.00034.au	disco
G:/PycharmProjects/musicgeneration/classificationbyCNN/mirex_test/folder/classical.00055.au	classical
G:/PycharmProjects/musicgeneration/classificationbyCNN/mirex_test/folder/classical.00012.au	classical
G:/PycharmProjects/musicgeneration/classificationbyCNN/mirex_test/folder/pop.00011.au	pop
G:/PycharmProjects/musicgeneration/classificationbyCNN/mirex_test/folder/country.00007.au	country
G:/PycharmProjects/musicgeneration/classificationbyCNN/mirex_test/folder/metal.00031.au	metal
G:/PycharmProjects/musicgeneration/classificationbyCNN/mirex_test/folder/country.00041.au	country
G:/PycharmProjects/musicgeneration/classificationbyCNN/mirex_test/folder/pop.00014.au	pop
G:/PycharmProjects/musicgeneration/classificationbyCNN/mirex_test/folder/rock.00020.au	rock
G:/PycharmProjects/musicgeneration/classificationbyCNN/mirex_test/folder/country.00028.au	country
G:/PycharmProjects/musicgeneration/classificationbyCNN/mirex_test/folder/disco.00012.au	disco
G:/PycharmProjects/musicgeneration/classificationbyCNN/mirex_test/folder/hiphop.00034.au	hiphop
G:/PycharmProjects/musicgeneration/classificationbyCNN/mirex_test/folder/rock.00098.au	rock
G:/PycharmProjects/musicgeneration/classificationbyCNN/mirex_test/folder/reggae.00036.au	reggae
G:/PycharmProjects/musicgeneration/classificationbyCNN/mirex_test/folder/hiphop.00091.au	hiphop
G:/PycharmProjects/musicgeneration/classificationbyCNN/mirex_test/folder/rock.00066.au	rock
G:/PycharmProjects/musicgeneration/classificationbyCNN/mirex_test/folder/reggae.00068.au	reggae
G:/PycharmProjects/musicgeneration/classificationbyCNN/mirex_test/folder/classical.00052.au	classical
G:/PycharmProjects/musicgeneration/classificationbyCNN/mirex_test/folder/hiphop.00056.au	hiphop
G:/PycharmProjects/musicgeneration/classificationbyCNN/mirex_test/folder/blues.00004.au	blues
G:/PycharmProjects/musicgeneration/classificationbyCNN/mirex_test/folder/jazz.00062.au	jazz
G:/PycharmProjects/musicgeneration/classificationbyCNN/mirex_test/folder/metal.00088.au	metal
G:/PycharmProjects/musicgeneration/classificationbyCNN/mirex_test/folder/reggae.00009.au	reggae
G:/PycharmProjects/musicgeneration/classificationbyCNN/mirex_test/folder/hiphop.00096.au	hiphop
G:/PycharmProjects/musicgeneration/classificationbyCNN/mirex_test/folder/hiphop.00039.au	hiphop
G:/PycharmProjects/musicgeneration/classificationbyCNN/mirex_test/folder/disco.00044.au	disco
G:/PycharmProjects/musicgeneration/classificationbyCNN/mirex_test/folder/jazz.00035.au	jazz
G:/PycharmProjects/musicgeneration/classificationbyCNN/mirex_test/folder/disco.00023.au	disco
G:/PycharmProjects/musicgeneration/classificationbyCNN/mirex_test/folder/country.00086.au	country
G:/PycharmProjects/musicgeneration/classificationbyCNN/mirex_test/folder/reggae.00025.au	reggae
G:/PycharmProjects/musicgeneration/classificationbyCNN/mirex_test/folder/blues.00060.au	blues
G:/PycharmProjects/musicgeneration/classificationbyCNN/mirex_test/folder/metal.00073.au	metal
G:/PycharmProjects/musicgeneration/classificationbyCNN/mirex_test/folder/blues.00013.au	blues
G:/PycharmProjects/musicgeneration/classificationbyCNN/mirex_test/folder/country.00093.au	country
G:/PycharmProjects/musicgeneration/classificationbyCNN/mirex_test/folder/metal.00049.au	metal
G:/PycharmProjects/musicgeneration/classificationbyCNN/mirex_test/folder/hiphop.00022.au	hiphop
G:/PycharmProjects/musicgeneration/classificationbyCNN/mirex_test/folder/pop.00048.au	pop
G:/PycharmProjects/musicgeneration/classificationbyCNN/mirex_test/folder/jazz.00078.au	jazz
G:/PycharmProjects/musicgeneration/classificationbyCNN/mirex_test/folder/blues.00029.au	blues
G:/PycharmProjects/musicgeneration/classificationbyCNN/mirex_test/folder/disco.00051.au	disco
G:/PycharmProjects/musicgeneration/classificationbyCNN/mirex_test/folder/blues.00040.au	blues
G:/PycharmProjects/musicgeneration/classificationbyCNN/mirex_test/folder/reggae.00061.au	reggae
G:/PycharmProjects/musicgeneration/classificationbyCNN/mirex_test/folder/blues.00052.au	blues
G:/PycharmProjects/musicgeneration/classificationbyCNN/mirex_test/folder/country.00050.au	country
G:/PycharmProjects/musicgeneration/classificationbyCNN/mirex_test/folder/reggae.00013.au	reggae
G:/PycharmProjects/musicgeneration/classificationbyCNN/mirex_test/folder/reggae.00069.au	reggae
G:/PycharmProjects/musicgeneration/classificationbyCNN/mirex_test/folder/metal.00083.au	metal
G:/PycharmProjects/musicgeneration/classificationbyCNN/mirex_test/folder/jazz.00032.au	jazz
G:/PycharmProjects/musicgeneration/classificationbyCNN/mirex_test/folder/country.00074.au	country
G:/PycharmProjects/musicgeneration/classificationbyCNN/mirex_test/folder/rock.00016.au	rock
G:/PycharmProjects/musicgeneration/classificationbyCNN/mirex_test/folder/blues.00033.au	blues
G:/PycharmProjects/musicgeneration/classificationbyCNN/mirex_test/folder/metal.00002.au	metal
G:/PycharmProjects/musicgeneration/classificationbyCNN/mirex_test/folder/metal.00029.au	metal
G:/PycharmProjects/musicgeneration/classificationbyCNN/mirex_test/folder/reggae.00031.au	reggae
G:/PycharmProjects/musicgeneration/classificationbyCNN/mirex_test/folder/pop.00090.au	pop
G:/PycharmProjects/musicgeneration/classificationbyCNN/mirex_test/folder/hiphop.00026.au	hiphop
G:/PycharmProjects/musicgeneration/classificationbyCNN/mirex_test/folder/hiphop.00066.au	hiphop
G:/PycharmProjects/musicgeneration/classificationbyCNN/mirex_test/folder/disco.00082.au	disco
G:/PycharmProjects/musicgeneration/classificationbyCNN/mirex_test/folder/classical.00075.au	classical
G:/PycharmProjects/musicgeneration/classificationbyCNN/mirex_test/folder/metal.00086.au	metal
G:/PycharmProjects/musicgeneration/classificationbyCNN/mirex_test/folder/blues.00063.au	blues
G:/PycharmProjects/musicgeneration/classificationbyCNN/mirex_test/folder/blues.00093.au	blues
G:/PycharmProjects/musicgeneration/classificationbyCNN/mirex_test/folder/country.00008.au	country
G:/PycharmProjects/musicgeneration/classificationbyCNN/mirex_test/folder/hiphop.00005.au	hiphop
G:/PycharmProjects/musicgeneration/classificationbyCNN/mirex_test/folder/metal.00034.au	metal
G:/PycharmProjects/musicgeneration/classificationbyCNN/mirex_test/folder/hiphop.00055.au	hiphop
G:/PycharmProjects/musicgeneration/classificationbyCNN/mirex_test/folder/classical.00067.au	classical
G:/PycharmProjects/musicgeneration/classificationbyCNN/mirex_test/folder/country.00065.au	country
G:/PycharmProjects/musicgeneration/classificationbyCNN/mirex_test/folder/country.00094.au	country
G:/PycharmProjects/musicgeneration/classificationbyCNN/mirex_test/folder/jazz.00087.au	jazz
G:/PycharmProjects/musicgeneration/classificationbyCNN/mirex_test/folder/reggae.00083.au	reggae
G:/PycharmProjects/musicgeneration/classificationbyCNN/mirex_test/folder/pop.00091.au	pop
G:/PycharmProjects/musicgeneration/classificationbyCNN/mirex_test/folder/country.00092.au	country
G:/PycharmProjects/musicgeneration/classificationbyCNN/mirex_test/folder/hiphop.00041.au	hiphop
G:/PycharmProjects/musicgeneration/classificationbyCNN/mirex_test/folder/country.00089.au	country
G:/PycharmProjects/musicgeneration/classificationbyCNN/mirex_test/folder/reggae.00033.au	reggae
G:/PycharmProjects/musicgeneration/classificationbyCNN/mirex_test/folder/pop.00008.au	pop
G:/PycharmProjects/musicgeneration/classificationbyCNN/mirex_test/folder/country.00053.au	country
G:/PycharmProjects/musicgeneration/classificationbyCNN/mirex_test/folder/hiphop.00090.au	hiphop
G:/PycharmProjects/musicgeneration/classificationbyCNN/mirex_test/folder/metal.00036.au	metal
G:/PycharmProjects/musicgeneration/classificationbyCNN/mirex_test/folder/country.00087.au	country
G:/PycharmProjects/musicgeneration/classificationbyCNN/mirex_test/folder/country.00027.au	country
G:/PycharmProjects/musicgeneration/classificationbyCNN/mirex_test/folder/country.00019.au	country
G:/PycharmProjects/musicgeneration/classificationbyCNN/mirex_test/folder/blues.00001.au	blues
G:/PycharmProjects/musicgeneration/classificationbyCNN/mirex_test/folder/pop.00033.au	pop
G:/PycharmProjects/musicgeneration/classificationbyCNN/mirex_test/folder/blues.00036.au	blues
G:/PycharmProjects/musicgeneration/classificationbyCNN/mirex_test/folder/metal.00007.au	metal
G:/PycharmProjects/musicgeneration/classificationbyCNN/mirex_test/folder/rock.00084.au	rock
G:/PycharmProjects/musicgeneration/classificationbyCNN/mirex_test/folder/disco.00077.au	disco
G:/PycharmProjects/musicgeneration/classificationbyCNN/mirex_test/folder/pop.00045.au	pop
G:/PycharmProjects/musicgeneration/classificationbyCNN/mirex_test/folder/rock.00069.au	rock
G:/PycharmProjects/musicgeneration/classificationbyCNN/mirex_test/folder/metal.00093.au	metal
G:/PycharmProjects/musicgeneration/classificationbyCNN/mirex_test/folder/blues.00047.au	blues
G:/PycharmProjects/musicgeneration/classificationbyCNN/mirex_test/folder/classical.00062.au	classical
G:/PycharmProjects/musicgeneration/classificationbyCNN/mirex_test/folder/jazz.00090.au	jazz
G:/PycharmProjects/musicgeneration/classificationbyCNN/mirex_test/folder/disco.00067.au	disco
G:/PycharmProjects/musicgeneration/classificationbyCNN/mirex_test/folder/reggae.00020.au	reggae
G:/PycharmProjects/musicgeneration/classificationbyCNN/mirex_test/folder/classical.00026.au	classical
G:/PycharmProjects/musicgeneration/classificationbyCNN/mirex_test/folder/rock.00092.au	rock
G:/PycharmProjects/musicgeneration/classificationbyCNN/mirex_test/folder/rock.00058.au	rock
G:/PycharmProjects/musicgeneration/classificationbyCNN/mirex_test/folder/metal.00058.au	metal
G:/PycharmProjects/musicgeneration/classificationbyCNN/mirex_test/folder/rock.00011.au	rock
G:/PycharmProjects/musicgeneration/classificationbyCNN/mirex_test/folder/disco.00060.au	disco
G:/PycharmProjects/musicgeneration/classificationbyCNN/mirex_test/folder/reggae.00037.au	reggae
G:/PycharmProjects/musicgeneration/classificationbyCNN/mirex_test/folder/disco.00040.au	disco
G:/PycharmProjects/musicgeneration/classificationbyCNN/mirex_test/folder/reggae.00084.au	reggae
G:/PycharmProjects/musicgeneration/classificationbyCNN/mirex_test/folder/blues.00032.au	blues
G:/PycharmProjects/musicgeneration/classificationbyCNN/mirex_test/folder/jazz.00048.au	jazz
G:/PycharmProjects/musicgeneration/classificationbyCNN/mirex_test/folder/disco.00074.au	disco
G:/PycharmProjects/musicgeneration/classificationbyCNN/mirex_test/folder/pop.00056.au	pop
G:/PycharmProjects/musicgeneration/classificationbyCNN/mirex_test/folder/classical.00031.au	classical
G:/PycharmProjects/musicgeneration/classificationbyCNN/mirex_test/folder/rock.00050.au	rock
G:/PycharmProjects/musicgeneration/classificationbyCNN/mirex_test/folder/blues.00082.au	blues
G:/PycharmProjects/musicgeneration/classificationbyCNN/mirex_test/folder/metal.00012.au	metal
G:/PycharmProjects/musicgeneration/classificationbyCNN/mirex_test/folder/reggae.00038.au	reggae
G:/PycharmProjects/musicgeneration/classificationbyCNN/mirex_test/folder/hiphop.00011.au	hiphop
G:/PycharmProjects/musicgeneration/classificationbyCNN/mirex_test/folder/blues.00059.au	blues
G:/PycharmProjects/musicgeneration/classificationbyCNN/mirex_test/folder/rock.00071.au	rock
G:/PycharmProjects/musicgeneration/classificationbyCNN/mirex_test/folder/country.00066.au	country
G:/PycharmProjects/musicgeneration/classificationbyCNN/mirex_test/folder/rock.00047.au	rock
G:/PycharmProjects/musicgeneration/classificationbyCNN/mirex_test/folder/reggae.00057.au	reggae
G:/PycharmProjects/musicgeneration/classificationbyCNN/mirex_test/folder/classical.00053.au	classical
G:/PycharmProjects/musicgeneration/classificationbyCNN/mirex_test/folder/country.00048.au	country
G:/PycharmProjects/musicgeneration/classificationbyCNN/mirex_test/folder/country.00077.au	country
G:/PycharmProjects/musicgeneration/classificationbyCNN/mirex_test/folder/blues.00085.au	blues
G:/PycharmProjects/musicgeneration/classificationbyCNN/mirex_test/folder/jazz.00018.au	jazz
G:/PycharmProjects/musicgeneration/classificationbyCNN/mirex_test/folder/classical.00021.au	classical
G:/PycharmProjects/musicgeneration/classificationbyCNN/mirex_test/folder/country.00006.au	country
G:/PycharmProjects/musicgeneration/classificationbyCNN/mirex_test/folder/hiphop.00053.au	hiphop
G:/PycharmProjects/musicgeneration/classificationbyCNN/mirex_test/folder/country.00015.au	country
G:/PycharmProjects/musicgeneration/classificationbyCNN/mirex_test/folder/pop.00083.au	pop
G:/PycharmProjects/musicgeneration/classificationbyCNN/mirex_test/folder/pop.00081.au	pop
G:/PycharmProjects/musicgeneration/classificationbyCNN/mirex_test/folder/metal.00014.au	metal
G:/PycharmProjects/musicgeneration/classificationbyCNN/mirex_test/folder/metal.00059.au	metal
G:/PycharmProjects/musicgeneration/classificationbyCNN/mirex_test/folder/rock.00022.au	rock
G:/PycharmProjects/musicgeneration/classificationbyCNN/mirex_test/folder/reggae.00099.au	reggae
G:/PycharmProjects/musicgeneration/classificationbyCNN/mirex_test/folder/jazz.00088.au	jazz
G:/PycharmProjects/musicgeneration/classificationbyCNN/mirex_test/folder/pop.00030.au	pop
G:/PycharmProjects/musicgeneration/classificationbyCNN/mirex_test/folder/classical.00092.au	classical
G:/PycharmProjects/musicgeneration/classificationbyCNN/mirex_test/folder/blues.00070.au	blues
G:/PycharmProjects/musicgeneration/classificationbyCNN/mirex_test/folder/pop.00020.au	pop
G:/PycharmProjects/musicgeneration/classificationbyCNN/mirex_test/folder/reggae.00049.au	reggae
G:/PycharmProjects/musicgeneration/classificationbyCNN/mirex_test/folder/reggae.00046.au	reggae
G:/PycharmProjects/musicgeneration/classificationbyCNN/mirex_test/folder/disco.00004.au	disco
G:/PycharmProjects/musicgeneration/classificationbyCNN/mirex_test/folder/classical.00014.au	classical
G:/PycharmProjects/musicgeneration/classificationbyCNN/mirex_test/folder/jazz.00051.au	jazz
G:/PycharmProjects/musicgeneration/classificationbyCNN/mirex_test/folder/classical.00001.au	classical
G:/PycharmProjects/musicgeneration/classificationbyCNN/mirex_test/folder/metal.00052.au	metal
G:/PycharmProjects/musicgeneration/classificationbyCNN/mirex_test/folder/blues.00020.au	blues
G:/PycharmProjects/musicgeneration/classificationbyCNN/mirex_test/folder/hiphop.00088.au	hiphop
G:/PycharmProjects/musicgeneration/classificationbyCNN/mirex_test/folder/jazz.00008.au	jazz
G:/PycharmProjects/musicgeneration/classificationbyCNN/mirex_test/folder/country.00004.au	country
G:/PycharmProjects/musicgeneration/classificationbyCNN/mirex_test/folder/hiphop.00029.au	hiphop
G:/PycharmProjects/musicgeneration/classificationbyCNN/mirex_test/folder/country.00059.au	country
G:/PycharmProjects/musicgeneration/classificationbyCNN/mirex_test/folder/pop.00032.au	pop
G:/PycharmProjects/musicgeneration/classificationbyCNN/mirex_test/folder/hiphop.00099.au	hiphop
G:/PycharmProjects/musicgeneration/classificationbyCNN/mirex_test/folder/reggae.00035.au	reggae
G:/PycharmProjects/musicgeneration/classificationbyCNN/mirex_test/folder/hiphop.00023.au	hiphop
G:/PycharmProjects/musicgeneration/classificationbyCNN/mirex_test/folder/metal.00042.au	metal
G:/PycharmProjects/musicgeneration/classificationbyCNN/mirex_test/folder/country.00070.au	country
G:/PycharmProjects/musicgeneration/classificationbyCNN/mirex_test/folder/reggae.00082.au	reggae
G:/PycharmProjects/musicgeneration/classificationbyCNN/mirex_test/folder/reggae.00092.au	reggae
G:/PycharmProjects/musicgeneration/classificationbyCNN/mirex_test/folder/pop.00053.au	pop
G:/PycharmProjects/musicgeneration/classificationbyCNN/mirex_test/folder/hiphop.00043.au	hiphop
G:/PycharmProjects/musicgeneration/classificationbyCNN/mirex_test/folder/jazz.00077.au	jazz
G:/PycharmProjects/musicgeneration/classificationbyCNN/mirex_test/folder/blues.00090.au	blues
G:/PycharmProjects/musicgeneration/classificationbyCNN/mirex_test/folder/pop.00065.au	pop
G:/PycharmProjects/musicgeneration/classificationbyCNN/mirex_test/folder/reggae.00034.au	reggae
G:/PycharmProjects/musicgeneration/classificationbyCNN/mirex_test/folder/jazz.00056.au	jazz
G:/PycharmProjects/musicgeneration/classificationbyCNN/mirex_test/folder/hiphop.00018.au	hiphop
G:/PycharmProjects/musicgeneration/classificationbyCNN/mirex_test/folder/country.00088.au	country
G:/PycharmProjects/musicgeneration/classificationbyCNN/mirex_test/folder/disco.00084.au	disco
G:/PycharmProjects/musicgeneration/classificationbyCNN/mirex_test/folder/blues.00089.au	blues
G:/PycharmProjects/musicgeneration/classificationbyCNN/mirex_test/folder/hiphop.00098.au	hiphop
G:/PycharmProjects/musicgeneration/classificationbyCNN/mirex_test/folder/classical.00002.au	classical
G:/PycharmProjects/musicgeneration/classificationbyCNN/mirex_test/folder/disco.00009.au	disco
G:/PycharmProjects/musicgeneration/classificationbyCNN/mirex_test/folder/country.00084.au	country
G:/PycharmProjects/musicgeneration/classificationbyCNN/mirex_test/folder/disco.00059.au	disco
G:/PycharmProjects/musicgeneration/classificationbyCNN/mirex_test/folder/hiphop.00071.au	hiphop
G:/PycharmProjects/musicgeneration/classificationbyCNN/mirex_test/folder/jazz.00053.au	jazz
G:/PycharmProjects/musicgeneration/classificationbyCNN/mirex_test/folder/reggae.00015.au	reggae
G:/PycharmProjects/musicgeneration/classificationbyCNN/mirex_test/folder/jazz.00002.au	jazz
G:/PycharmProjects/musicgeneration/classificationbyCNN/mirex_test/folder/pop.00093.au	pop
G:/PycharmProjects/musicgeneration/classificationbyCNN/mirex_test/folder/jazz.00020.au	jazz
G:/PycharmProjects/musicgeneration/classificationbyCNN/mirex_test/folder/rock.00043.au	rock
G:/PycharmProjects/musicgeneration/classificationbyCNN/mirex_test/folder/disco.00094.au	disco
G:/PycharmProjects/musicgeneration/classificationbyCNN/mirex_test/folder/country.00060.au	country
G:/PycharmProjects/musicgeneration/classificationbyCNN/mirex_test/folder/pop.00043.au	pop
G:/PycharmProjects/musicgeneration/classificationbyCNN/mirex_test/folder/metal.00019.au	metal
G:/PycharmProjects/musicgeneration/classificationbyCNN/mirex_test/folder/disco.00054.au	disco
G:/PycharmProjects/musicgeneration/classificationbyCNN/mirex_test/folder/jazz.00022.au	jazz
G:/PycharmProjects/musicgeneration/classificationbyCNN/mirex_test/folder/classical.00007.au	classical
G:/PycharmProjects/musicgeneration/classificationbyCNN/mirex_test/folder/jazz.00017.au	jazz
G:/PycharmProjects/musicgeneration/classificationbyCNN/mirex_test/folder/rock.00024.au	rock
G:/PycharmProjects/musicgeneration/classificationbyCNN/mirex_test/folder/reggae.00048.au	reggae
G:/PycharmProjects/musicgeneration/classificationbyCNN/mirex_test/folder/metal.00069.au	metal
G:/PycharmProjects/musicgeneration/classificationbyCNN/mirex_test/folder/pop.00095.au	pop
G:/PycharmProjects/musicgeneration/classificationbyCNN/mirex_test/folder/jazz.00060.au	jazz
G:/PycharmProjects/musicgeneration/classificationbyCNN/mirex_test/folder/hiphop.00052.au	hiphop
G:/PycharmProjects/musicgeneration/classificationbyCNN/mirex_test/folder/jazz.00025.au	jazz
G:/PycharmProjects/musicgeneration/classificationbyCNN/mirex_test/folder/pop.00000.au	pop
G:/PycharmProjects/musicgeneration/classificationbyCNN/mirex_test/folder/rock.00009.au	rock
G:/PycharmProjects/musicgeneration/classificationbyCNN/mirex_test/folder/blues.00015.au	blues
G:/PycharmProjects/musicgeneration/classificationbyCNN/mirex_test/folder/jazz.00001.au	jazz
G:/PycharmProjects/musicgeneration/classificationbyCNN/mirex_test/folder/blues.00027.au	blues
G:/PycharmProjects/musicgeneration/classificationbyCNN/mirex_test/folder/pop.00009.au	pop
G:/PycharmProjects/musicgeneration/classificationbyCNN/mirex_test/folder/metal.00051.au	metal
G:/PycharmProjects/musicgeneration/classificationbyCNN/mirex_test/folder/reggae.00066.au	reggae
G:/PycharmProjects/musicgeneration/classificationbyCNN/mirex_test/folder/hiphop.00044.au	hiphop
G:/PycharmProjects/musicgeneration/classificationbyCNN/mirex_test/folder/classical.00047.au	classical
G:/PycharmProjects/musicgeneration/classificationbyCNN/mirex_test/folder/country.00095.au	country
G:/PycharmProjects/musicgeneration/classificationbyCNN/mirex_test/folder/blues.00009.au	blues
G:/PycharmProjects/musicgeneration/classificationbyCNN/mirex_test/folder/pop.00098.au	pop
G:/PycharmProjects/musicgeneration/classificationbyCNN/mirex_test/folder/hiphop.00074.au	hiphop
G:/PycharmProjects/musicgeneration/classificationbyCNN/mirex_test/folder/rock.00097.au	rock
G:/PycharmProjects/musicgeneration/classificationbyCNN/mirex_test/folder/rock.00032.au	rock
G:/PycharmProjects/musicgeneration/classificationbyCNN/mirex_test/folder/country.00071.au	country
G:/PycharmProjects/musicgeneration/classificationbyCNN/mirex_test/folder/jazz.00074.au	jazz
G:/PycharmProjects/musicgeneration/classificationbyCNN/mirex_test/folder/blues.00069.au	blues
G:/PycharmProjects/musicgeneration/classificationbyCNN/mirex_test/folder/reggae.00081.au	reggae
G:/PycharmProjects/musicgeneration/classificationbyCNN/mirex_test/folder/pop.00015.au	pop
G:/PycharmProjects/musicgeneration/classificationbyCNN/mirex_test/folder/blues.00039.au	blues
G:/PycharmProjects/musicgeneration/classificationbyCNN/mirex_test/folder/hiphop.00073.au	hiphop
G:/PycharmProjects/musicgeneration/classificationbyCNN/mirex_test/folder/hiphop.00021.au	hiphop
G:/PycharmProjects/musicgeneration/classificationbyCNN/mirex_test/folder/metal.00099.au	metal
G:/PycharmProjects/musicgeneration/classificationbyCNN/mirex_test/folder/classical.00066.au	classical
G:/PycharmProjects/musicgeneration/classificationbyCNN/mirex_test/folder/country.00037.au	country
G:/PycharmProjects/musicgeneration/classificationbyCNN/mirex_test/folder/rock.00096.au	rock
G:/PycharmProjects/musicgeneration/classificationbyCNN/mirex_test/folder/reggae.00002.au	reggae
G:/PycharmProjects/musicgeneration/classificationbyCNN/mirex_test/folder/classical.00046.au	classical
G:/PycharmProjects/musicgeneration/classificationbyCNN/mirex_test/folder/rock.00045.au	rock
G:/PycharmProjects/musicgeneration/classificationbyCNN/mirex_test/folder/disco.00037.au	disco
G:/PycharmProjects/musicgeneration/classificationbyCNN/mirex_test/folder/reggae.00032.au	reggae
G:/PycharmProjects/musicgeneration/classificationbyCNN/mirex_test/folder/pop.00027.au	pop
G:/PycharmProjects/musicgeneration/classificationbyCNN/mirex_test/folder/rock.00039.au	rock
G:/PycharmProjects/musicgeneration/classificationbyCNN/mirex_test/folder/disco.00093.au	disco
G:/PycharmProjects/musicgeneration/classificationbyCNN/mirex_test/folder/hiphop.00009.au	hiphop
G:/PycharmProjects/musicgeneration/classificationbyCNN/mirex_test/folder/disco.00047.au	disco
G:/PycharmProjects/musicgeneration/classificationbyCNN/mirex_test/folder/country.00075.au	country
G:/PycharmProjects/musicgeneration/classificationbyCNN/mirex_test/folder/rock.00006.au	rock
G:/PycharmProjects/musicgeneration/classificationbyCNN/mirex_test/folder/blues.00092.au	blues
G:/PycharmProjects/musicgeneration/classificationbyCNN/mirex_test/folder/country.00000.au	country
G:/PycharmProjects/musicgeneration/classificationbyCNN/mirex_test/folder/country.00057.au	country
G:/PycharmProjects/musicgeneration/classificationbyCNN/mirex_test/folder/pop.00052.au	pop
G:/PycharmProjects/musicgeneration/classificationbyCNN/mirex_test/folder/reggae.00008.au	reggae
G:/PycharmProjects/musicgeneration/classificationbyCNN/mirex_test/folder/metal.00030.au	metal
G:/PycharmProjects/musicgeneration/classificationbyCNN/mirex_test/folder/jazz.00096.au	jazz
G:/PycharmProjects/musicgeneration/classificationbyCNN/mirex_test/folder/reggae.00058.au	reggae
G:/PycharmProjects/musicgeneration/classificationbyCNN/mirex_test/folder/disco.00076.au	disco
G:/PycharmProjects/musicgeneration/classificationbyCNN/mirex_test/folder/hiphop.00049.au	hiphop
G:/PycharmProjects/musicgeneration/classificationbyCNN/mirex_test/folder/pop.00088.au	pop
G:/PycharmProjects/musicgeneration/classificationbyCNN/mirex_test/folder/blues.00054.au	blues
G:/PycharmProjects/musicgeneration/classificationbyCNN/mirex_test/folder/pop.00028.au	pop
G:/PycharmProjects/musicgeneration/classificationbyCNN/mirex_test/folder/jazz.00040.au	jazz
G:/PycharmProjects/musicgeneration/classificationbyCNN/mirex_test/folder/reggae.00004.au	reggae
G:/PycharmProjects/musicgeneration/classificationbyCNN/mirex_test/folder/disco.00070.au	disco
G:/PycharmProjects/musicgeneration/classificationbyCNN/mirex_test/folder/rock.00000.au	rock
G:/PycharmProjects/musicgeneration/classificationbyCNN/mirex_test/folder/blues.00071.au	blues
G:/PycharmProjects/musicgeneration/classificationbyCNN/mirex_test/folder/rock.00063.au	rock
G:/PycharmProjects/musicgeneration/classificationbyCNN/mirex_test/folder/disco.00039.au	disco
G:/PycharmProjects/musicgeneration/classificationbyCNN/mirex_test/folder/pop.00071.au	pop
G:/PycharmProjects/musicgeneration/classificationbyCNN/mirex_test/folder/blues.00083.au	blues
G:/PycharmProjects/musicgeneration/classificationbyCNN/mirex_test/folder/reggae.00062.au	reggae
G:/PycharmProjects/musicgeneration/classificationbyCNN/mirex_test/folder/blues.00022.au	blues
G:/PycharmProjects/musicgeneration/classificationbyCNN/mirex_test/folder/classical.00018.au	classical
G:/PycharmProjects/musicgeneration/classificationbyCNN/mirex_test/folder/hiphop.00054.au	hiphop
G:/PycharmProjects/musicgeneration/classificationbyCNN/mirex_test/folder/pop.00002.au	pop
G:/PycharmProjects/musicgeneration/classificationbyCNN/mirex_test/folder/metal.00050.au	metal
G:/PycharmProjects/musicgeneration/classificationbyCNN/mirex_test/folder/classical.00085.au	classical
G:/PycharmProjects/musicgeneration/classificationbyCNN/mirex_test/folder/jazz.00026.au	jazz
G:/PycharmProjects/musicgeneration/classificationbyCNN/mirex_test/folder/country.00079.au	country
G:/PycharmProjects/musicgeneration/classificationbyCNN/mirex_test/folder/disco.00079.au	disco
G:/PycharmProjects/musicgeneration/classificationbyCNN/mirex_test/folder/country.00073.au	country
G:/PycharmProjects/musicgeneration/classificationbyCNN/mirex_test/folder/rock.00013.au	rock
G:/PycharmProjects/musicgeneration/classificationbyCNN/mirex_test/folder/hiphop.00042.au	hiphop
G:/PycharmProjects/musicgeneration/classificationbyCNN/mirex_test/folder/classical.00074.au	classical
G:/PycharmProjects/musicgeneration/classificationbyCNN/mirex_test/folder/pop.00094.au	pop
G:/PycharmProjects/musicgeneration/classificationbyCNN/mirex_test/folder/jazz.00084.au	jazz
G:/PycharmProjects/musicgeneration/classificationbyCNN/mirex_test/folder/disco.00053.au	disco
G:/PycharmProjects/musicgeneration/classificationbyCNN/mirex_test/folder/blues.00014.au	blues
G:/PycharmProjects/musicgeneration/classificationbyCNN/mirex_test/folder/jazz.00010.au	jazz
G:/PycharmProjects/musicgeneration/classificationbyCNN/mirex_test/folder/disco.00072.au	disco
G:/PycharmProjects/musicgeneration/classificationbyCNN/mirex_test/folder/blues.00021.au	blues
G:/PycharmProjects/musicgeneration/classificationbyCNN/mirex_test/folder/blues.00075.au	blues
G:/PycharmProjects/musicgeneration/classificationbyCNN/mirex_test/folder/country.00045.au	country
G:/PycharmProjects/musicgeneration/classificationbyCNN/mirex_test/folder/disco.00099.au	disco
G:/PycharmProjects/musicgeneration/classificationbyCNN/mirex_test/folder/disco.00061.au	disco
G:/PycharmProjects/musicgeneration/classificationbyCNN/mirex_test/folder/jazz.00005.au	jazz
G:/PycharmProjects/musicgeneration/classificationbyCNN/mirex_test/folder/hiphop.00010.au	hiphop
G:/PycharmProjects/musicgeneration/classificationbyCNN/mirex_test/folder/metal.00001.au	metal
G:/PycharmProjects/musicgeneration/classificationbyCNN/mirex_test/folder/metal.00087.au	metal
G:/PycharmProjects/musicgeneration/classificationbyCNN/mirex_test/folder/pop.00099.au	pop
G:/PycharmProjects/musicgeneration/classificationbyCNN/mirex_test/folder/disco.00095.au	disco
G:/PycharmProjects/musicgeneration/classificationbyCNN/mirex_test/folder/jazz.00000.au	jazz
G:/PycharmProjects/musicgeneration/classificationbyCNN/mirex_test/folder/pop.00040.au	pop
G:/PycharmProjects/musicgeneration/classificationbyCNN/mirex_test/folder/rock.00040.au	rock
G:/PycharmProjects/musicgeneration/classificationbyCNN/mirex_test/folder/reggae.00088.au	reggae
G:/PycharmProjects/musicgeneration/classificationbyCNN/mirex_test/folder/classical.00073.au	classical
G:/PycharmProjects/musicgeneration/classificationbyCNN/mirex_test/folder/disco.00024.au	disco
G:/PycharmProjects/musicgeneration/classificationbyCNN/mirex_test/folder/hiphop.00020.au	hiphop
G:/PycharmProjects/musicgeneration/classificationbyCNN/mirex_test/folder/jazz.00021.au	jazz
G:/PycharmProjects/musicgeneration/classificationbyCNN/mirex_test/folder/metal.00016.au	metal
G:/PycharmProjects/musicgeneration/classificationbyCNN/mirex_test/folder/classical.00016.au	classical
G:/PycharmProjects/musicgeneration/classificationbyCNN/mirex_test/folder/jazz.00038.au	jazz
G:/PycharmProjects/musicgeneration/classificationbyCNN/mirex_test/folder/jazz.00015.au	jazz
G:/PycharmProjects/musicgeneration/classificationbyCNN/mirex_test/folder/blues.00043.au	blues
G:/PycharmProjects/musicgeneration/classificationbyCNN/mirex_test/folder/hiphop.00068.au	hiphop
G:/PycharmProjects/musicgeneration/classificationbyCNN/mirex_test/folder/disco.00014.au	disco
G:/PycharmProjects/musicgeneration/classificationbyCNN/mirex_test/folder/blues.00016.au	blues
G:/PycharmProjects/musicgeneration/classificationbyCNN/mirex_test/folder/metal.00091.au	metal
G:/PycharmProjects/musicgeneration/classificationbyCNN/mirex_test/folder/country.00002.au	country
G:/PycharmProjects/musicgeneration/classificationbyCNN/mirex_test/folder/classical.00044.au	classical
G:/PycharmProjects/musicgeneration/classificationbyCNN/mirex_test/folder/country.00040.au	country
G:/PycharmProjects/musicgeneration/classificationbyCNN/mirex_test/folder/metal.00033.au	metal
G:/PycharmProjects/musicgeneration/classificationbyCNN/mirex_test/folder/disco.00052.au	disco
G:/PycharmProjects/musicgeneration/classificationbyCNN/mirex_test/folder/hiphop.00050.au	hiphop
G:/PycharmProjects/musicgeneration/classificationbyCNN/mirex_test/folder/pop.00058.au	pop
G:/PycharmProjects/musicgeneration/classificationbyCNN/mirex_test/folder/hiphop.00062.au	hiphop
G:/PycharmProjects/musicgeneration/classificationbyCNN/mirex_test/folder/reggae.00007.au	reggae
G:/PycharmProjects/musicgeneration/classificationbyCNN/mirex_test/folder/pop.00087.au	pop
G:/PycharmProjects/musicgeneration/classificationbyCNN/mirex_test/folder/hiphop.00092.au	hiphop
G:/PycharmProjects/musicgeneration/classificationbyCNN/mirex_test/folder/blues.00038.au	blues
G:/PycharmProjects/musicgeneration/classificationbyCNN/mirex_test/folder/rock.00021.au	rock
G:/PycharmProjects/musicgeneration/classificationbyCNN/mirex_test/folder/country.00024.au	country
G:/PycharmProjects/musicgeneration/classificationbyCNN/mirex_test/folder/jazz.00004.au	jazz
G:/PycharmProjects/musicgeneration/classificationbyCNN/mirex_test/folder/reggae.00073.au	reggae
G:/PycharmProjects/musicgeneration/classificationbyCNN/mirex_test/folder/blues.00064.au	blues
G:/PycharmProjects/musicgeneration/classificationbyCNN/mirex_test/folder/metal.00082.au	metal
G:/PycharmProjects/musicgeneration/classificationbyCNN/mirex_test/folder/classical.00042.au	classical
G:/PycharmProjects/musicgeneration/classificationbyCNN/mirex_test/folder/rock.00057.au	rock
G:/PycharmProjects/musicgeneration/classificationbyCNN/mirex_test/folder/jazz.00049.au	jazz
G:/PycharmProjects/musicgeneration/classificationbyCNN/mirex_test/folder/hiphop.00076.au	hiphop
G:/PycharmProjects/musicgeneration/classificationbyCNN/mirex_test/folder/rock.00078.au	rock
G:/PycharmProjects/musicgeneration/classificationbyCNN/mirex_test/folder/rock.00064.au	rock
G:/PycharmProjects/musicgeneration/classificationbyCNN/mirex_test/folder/disco.00019.au	disco
G:/PycharmProjects/musicgeneration/classificationbyCNN/mirex_test/folder/metal.00057.au	metal
G:/PycharmProjects/musicgeneration/classificationbyCNN/mirex_test/folder/jazz.00023.au	jazz
G:/PycharmProjects/musicgeneration/classificationbyCNN/mirex_test/folder/pop.00023.au	pop
G:/PycharmProjects/musicgeneration/classificationbyCNN/mirex_test/folder/country.00009.au	country
G:/PycharmProjects/musicgeneration/classificationbyCNN/mirex_test/folder/reggae.00047.au	reggae
G:/PycharmProjects/musicgeneration/classificationbyCNN/mirex_test/folder/country.00047.au	country
G:/PycharmProjects/musicgeneration/classificationbyCNN/mirex_test/folder/metal.00023.au	metal
G:/PycharmProjects/musicgeneration/classificationbyCNN/mirex_test/folder/hiphop.00000.au	hiphop
G:/PycharmProjects/musicgeneration/classificationbyCNN/mirex_test/folder/blues.00017.au	blues
G:/PycharmProjects/musicgeneration/classificationbyCNN/mirex_test/folder/disco.00013.au	disco
G:/PycharmProjects/musicgeneration/classificationbyCNN/mirex_test/folder/disco.00056.au	disco
G:/PycharmProjects/musicgeneration/classificationbyCNN/mirex_test/folder/jazz.00092.au	jazz
G:/PycharmProjects/musicgeneration/classificationbyCNN/mirex_test/folder/country.00064.au	country
G:/PycharmProjects/musicgeneration/classificationbyCNN/mirex_test/folder/country.00011.au	country
G:/PycharmProjects/musicgeneration/classificationbyCNN/mirex_test/folder/classical.00023.au	classical
G:/PycharmProjects/musicgeneration/classificationbyCNN/mirex_test/folder/metal.00092.au	metal
G:/PycharmProjects/musicgeneration/classificationbyCNN/mirex_test/folder/disco.00057.au	disco
G:/PycharmProjects/musicgeneration/classificationbyCNN/mirex_test/folder/jazz.00043.au	jazz
G:/PycharmProjects/musicgeneration/classificationbyCNN/mirex_test/folder/classical.00015.au	classical
G:/PycharmProjects/musicgeneration/classificationbyCNN/mirex_test/folder/classical.00050.au	classical
G:/PycharmProjects/musicgeneration/classificationbyCNN/mirex_test/folder/pop.00029.au	pop
G:/PycharmProjects/musicgeneration/classificationbyCNN/mirex_test/folder/jazz.00014.au	jazz
G:/PycharmProjects/musicgeneration/classificationbyCNN/mirex_test/folder/country.00022.au	country
G:/PycharmProjects/musicgeneration/classificationbyCNN/mirex_test/folder/pop.00025.au	pop
G:/PycharmProjects/musicgeneration/classificationbyCNN/mirex_test/folder/jazz.00064.au	jazz
G:/PycharmProjects/musicgeneration/classificationbyCNN/mirex_test/folder/jazz.00082.au	jazz
G:/PycharmProjects/musicgeneration/classificationbyCNN/mirex_test/folder/rock.00034.au	rock
G:/PycharmProjects/musicgeneration/classificationbyCNN/mirex_test/folder/disco.00006.au	disco
G:/PycharmProjects/musicgeneration/classificationbyCNN/mirex_test/folder/disco.00098.au	disco
G:/PycharmProjects/musicgeneration/classificationbyCNN/mirex_test/folder/disco.00015.au	disco
G:/PycharmProjects/musicgeneration/classificationbyCNN/mirex_test/folder/reggae.00003.au	reggae
G:/PycharmProjects/musicgeneration/classificationbyCNN/mirex_test/folder/blues.00031.au	blues
G:/PycharmProjects/musicgeneration/classificationbyCNN/mirex_test/folder/rock.00081.au	rock
G:/PycharmProjects/musicgeneration/classificationbyCNN/mirex_test/folder/blues.00034.au	blues
G:/PycharmProjects/musicgeneration/classificationbyCNN/mirex_test/folder/country.00039.au	country
G:/PycharmProjects/musicgeneration/classificationbyCNN/mirex_test/folder/hiphop.00033.au	hiphop
G:/PycharmProjects/musicgeneration/classificationbyCNN/mirex_test/folder/reggae.00029.au	reggae
G:/PycharmProjects/musicgeneration/classificationbyCNN/mirex_test/folder/blues.00095.au	blues
G:/PycharmProjects/musicgeneration/classificationbyCNN/mirex_test/folder/country.00098.au	country
G:/PycharmProjects/musicgeneration/classificationbyCNN/mirex_test/folder/blues.00049.au	blues
G:/PycharmProjects/musicgeneration/classificationbyCNN/mirex_test/folder/jazz.00039.au	jazz
G:/PycharmProjects/musicgeneration/classificationbyCNN/mirex_test/folder/jazz.00013.au	jazz
G:/PycharmProjects/musicgeneration/classificationbyCNN/mirex_test/folder/disco.00030.au	disco
G:/PycharmProjects/musicgeneration/classificationbyCNN/mirex_test/folder/classical.00035.au	classical
G:/PycharmProjects/musicgeneration/classificationbyCNN/mirex_test/folder/reggae.00021.au	reggae
G:/PycharmProjects/musicgeneration/classificationbyCNN/mirex_test/folder/classical.00024.au	classical
G:/PycharmProjects/musicgeneration/classificationbyCNN/mirex_test/folder/disco.00016.au	disco
G:/PycharmProjects/musicgeneration/classificationbyCNN/mirex_test/folder/jazz.00044.au	jazz
G:/PycharmProjects/musicgeneration/classificationbyCNN/mirex_test/folder/rock.00031.au	rock
G:/PycharmProjects/musicgeneration/classificationbyCNN/mirex_test/folder/reggae.00077.au	reggae
G:/PycharmProjects/musicgeneration/classificationbyCNN/mirex_test/folder/blues.00066.au	blues
G:/PycharmProjects/musicgeneration/classificationbyCNN/mirex_test/folder/jazz.00069.au	jazz
G:/PycharmProjects/musicgeneration/classificationbyCNN/mirex_test/folder/classical.00040.au	classical
G:/PycharmProjects/musicgeneration/classificationbyCNN/mirex_test/folder/blues.00098.au	blues
G:/PycharmProjects/musicgeneration/classificationbyCNN/mirex_test/folder/metal.00024.au	metal
G:/PycharmProjects/musicgeneration/classificationbyCNN/mirex_test/folder/metal.00066.au	metal
G:/PycharmProjects/musicgeneration/classificationbyCNN/mirex_test/folder/hiphop.00015.au	hiphop
G:/PycharmProjects/musicgeneration/classificationbyCNN/mirex_test/folder/rock.00003.au	rock
G:/PycharmProjects/musicgeneration/classificationbyCNN/mirex_test/folder/jazz.00063.au	jazz
G:/PycharmProjects/musicgeneration/classificationbyCNN/mirex_test/folder/hiphop.00087.au	hiphop
G:/PycharmProjects/musicgeneration/classificationbyCNN/mirex_test/folder/rock.00015.au	rock
G:/PycharmProjects/musicgeneration/classificationbyCNN/mirex_test/folder/jazz.00052.au	jazz
G:/PycharmProjects/musicgeneration/classificationbyCNN/mirex_test/folder/metal.00035.au	metal
G:/PycharmProjects/musicgeneration/classificationbyCNN/mirex_test/folder/metal.00055.au	metal
G:/PycharmProjects/musicgeneration/classificationbyCNN/mirex_test/folder/country.00085.au	country
G:/PycharmProjects/musicgeneration/classificationbyCNN/mirex_test/folder/blues.00024.au	blues
G:/PycharmProjects/musicgeneration/classificationbyCNN/mirex_test/folder/pop.00016.au	pop
G:/PycharmProjects/musicgeneration/classificationbyCNN/mirex_test/folder/blues.00097.au	blues
G:/PycharmProjects/musicgeneration/classificationbyCNN/mirex_test/folder/hiphop.00032.au	hiphop
G:/PycharmProjects/musicgeneration/classificationbyCNN/mirex_test/folder/pop.00018.au	pop
G:/PycharmProjects/musicgeneration/classificationbyCNN/mirex_test/folder/reggae.00018.au	reggae
G:/PycharmProjects/musicgeneration/classificationbyCNN/mirex_test/folder/reggae.00052.au	reggae
G:/PycharmProjects/musicgeneration/classificationbyCNN/mirex_test/folder/disco.00002.au	disco
G:/PycharmProjects/musicgeneration/classificationbyCNN/mirex_test/folder/reggae.00078.au	reggae
G:/PycharmProjects/musicgeneration/classificationbyCNN/mirex_test/folder/blues.00096.au	blues
G:/PycharmProjects/musicgeneration/classificationbyCNN/mirex_test/folder/rock.00012.au	rock
G:/PycharmProjects/musicgeneration/classificationbyCNN/mirex_test/folder/country.00018.au	country
G:/PycharmProjects/musicgeneration/classificationbyCNN/mirex_test/folder/country.00026.au	country
G:/PycharmProjects/musicgeneration/classificationbyCNN/mirex_test/folder/country.00056.au	country
G:/PycharmProjects/musicgeneration/classificationbyCNN/mirex_test/folder/disco.00031.au	disco
G:/PycharmProjects/musicgeneration/classificationbyCNN/mirex_test/folder/reggae.00056.au	reggae
G:/PycharmProjects/musicgeneration/classificationbyCNN/mirex_test/folder/reggae.00060.au	reggae
G:/PycharmProjects/musicgeneration/classificationbyCNN/mirex_test/folder/blues.00012.au	blues
G:/PycharmProjects/musicgeneration/classificationbyCNN/mirex_test/folder/jazz.00095.au	jazz
G:/PycharmProjects/musicgeneration/classificationbyCNN/mirex_test/folder/disco.00090.au	disco
G:/PycharmProjects/musicgeneration/classificationbyCNN/mirex_test/folder/country.00090.au	country
G:/PycharmProjects/musicgeneration/classificationbyCNN/mirex_test/folder/classical.00049.au	classical
G:/PycharmProjects/musicgeneration/classificationbyCNN/mirex_test/folder/blues.00055.au	blues
G:/PycharmProjects/musicgeneration/classificationbyCNN/mirex_test/folder/reggae.00087.au	reggae
G:/PycharmProjects/musicgeneration/classificationbyCNN/mirex_test/folder/rock.00094.au	rock
G:/PycharmProjects/musicgeneration/classificationbyCNN/mirex_test/folder/disco.00068.au	disco
G:/PycharmProjects/musicgeneration/classificationbyCNN/mirex_test/folder/reggae.00059.au	reggae
G:/PycharmProjects/musicgeneration/classificationbyCNN/mirex_test/folder/rock.00091.au	rock
G:/PycharmProjects/musicgeneration/classificationbyCNN/mirex_test/folder/pop.00044.au	pop
G:/PycharmProjects/musicgeneration/classificationbyCNN/mirex_test/folder/country.00035.au	country
G:/PycharmProjects/musicgeneration/classificationbyCNN/mirex_test/folder/metal.00065.au	metal
G:/PycharmProjects/musicgeneration/classificationbyCNN/mirex_test/folder/disco.00036.au	disco
G:/PycharmProjects/musicgeneration/classificationbyCNN/mirex_test/folder/rock.00037.au	rock
G:/PycharmProjects/musicgeneration/classificationbyCNN/mirex_test/folder/country.00046.au	country
G:/PycharmProjects/musicgeneration/classificationbyCNN/mirex_test/folder/metal.00028.au	metal
G:/PycharmProjects/musicgeneration/classificationbyCNN/mirex_test/folder/disco.00081.au	disco
G:/PycharmProjects/musicgeneration/classificationbyCNN/mirex_test/folder/classical.00028.au	classical
G:/PycharmProjects/musicgeneration/classificationbyCNN/mirex_test/folder/metal.00076.au	metal
G:/PycharmProjects/musicgeneration/classificationbyCNN/mirex_test/folder/metal.00089.au	metal
G:/PycharmProjects/musicgeneration/classificationbyCNN/mirex_test/folder/jazz.00028.au	jazz
G:/PycharmProjects/musicgeneration/classificationbyCNN/mirex_test/folder/rock.00056.au	rock
G:/PycharmProjects/musicgeneration/classificationbyCNN/mirex_test/folder/rock.00008.au	rock
G:/PycharmProjects/musicgeneration/classificationbyCNN/mirex_test/folder/classical.00063.au	classical
G:/PycharmProjects/musicgeneration/classificationbyCNN/mirex_test/folder/rock.00089.au	rock
G:/PycharmProjects/musicgeneration/classificationbyCNN/mirex_test/folder/reggae.00079.au	reggae
G:/PycharmProjects/musicgeneration/classificationbyCNN/mirex_test/folder/pop.00021.au	pop
G:/PycharmProjects/musicgeneration/classificationbyCNN/mirex_test/folder/classical.00019.au	classical
G:/PycharmProjects/musicgeneration/classificationbyCNN/mirex_test/folder/classical.00022.au	classical
G:/PycharmProjects/musicgeneration/classificationbyCNN/mirex_test/folder/disco.00042.au	disco
G:/PycharmProjects/musicgeneration/classificationbyCNN/mirex_test/folder/reggae.00076.au	reggae
G:/PycharmProjects/musicgeneration/classificationbyCNN/mirex_test/folder/classical.00045.au	classical
G:/PycharmProjects/musicgeneration/classificationbyCNN/mirex_test/folder/classical.00072.au	classical
G:/PycharmProjects/musicgeneration/classificationbyCNN/mirex_test/folder/classical.00036.au	classical
G:/PycharmProjects/musicgeneration/classificationbyCNN/mirex_test/folder/blues.00067.au	blues
G:/PycharmProjects/musicgeneration/classificationbyCNN/mirex_test/folder/reggae.00040.au	reggae
G:/PycharmProjects/musicgeneration/classificationbyCNN/mirex_test/folder/classical.00041.au	classical
G:/PycharmProjects/musicgeneration/classificationbyCNN/mirex_test/folder/classical.00090.au	classical
G:/PycharmProjects/musicgeneration/classificationbyCNN/mirex_test/folder/disco.00010.au	disco
G:/PycharmProjects/musicgeneration/classificationbyCNN/mirex_test/folder/blues.00062.au	blues
G:/PycharmProjects/musicgeneration/classificationbyCNN/mirex_test/folder/classical.00096.au	classical
G:/PycharmProjects/musicgeneration/classificationbyCNN/mirex_test/folder/pop.00054.au	pop
G:/PycharmProjects/musicgeneration/classificationbyCNN/mirex_test/folder/blues.00056.au	blues
G:/PycharmProjects/musicgeneration/classificationbyCNN/mirex_test/folder/hiphop.00083.au	hiphop
G:/PycharmProjects/musicgeneration/classificationbyCNN/mirex_test/folder/blues.00050.au	blues
G:/PycharmProjects/musicgeneration/classificationbyCNN/mirex_test/folder/rock.00075.au	rock
G:/PycharmProjects/musicgeneration/classificationbyCNN/mirex_test/folder/jazz.00083.au	jazz
G:/PycharmProjects/musicgeneration/classificationbyCNN/mirex_test/folder/pop.00004.au	pop
G:/PycharmProjects/musicgeneration/classificationbyCNN/mirex_test/folder/metal.00017.au	metal
G:/PycharmProjects/musicgeneration/classificationbyCNN/mirex_test/folder/hiphop.00030.au	hiphop
G:/PycharmProjects/musicgeneration/classificationbyCNN/mirex_test/folder/rock.00051.au	rock
G:/PycharmProjects/musicgeneration/classificationbyCNN/mirex_test/folder/rock.00010.au	rock
G:/PycharmProjects/musicgeneration/classificationbyCNN/mirex_test/folder/pop.00076.au	pop
G:/PycharmProjects/musicgeneration/classificationbyCNN/mirex_test/folder/jazz.00033.au	jazz
G:/PycharmProjects/musicgeneration/classificationbyCNN/mirex_test/folder/disco.00021.au	disco
G:/PycharmProjects/musicgeneration/classificationbyCNN/mirex_test/folder/blues.00005.au	blues
G:/PycharmProjects/musicgeneration/classificationbyCNN/mirex_test/folder/blues.00048.au	blues
G:/PycharmProjects/musicgeneration/classificationbyCNN/mirex_test/folder/pop.00070.au	pop
G:/PycharmProjects/musicgeneration/classificationbyCNN/mirex_test/folder/disco.00050.au	disco
G:/PycharmProjects/musicgeneration/classificationbyCNN/mirex_test/folder/metal.00010.au	metal
G:/PycharmProjects/musicgeneration/classificationbyCNN/mirex_test/folder/country.00012.au	country
G:/PycharmProjects/musicgeneration/classificationbyCNN/mirex_test/folder/reggae.00094.au	reggae
G:/PycharmProjects/musicgeneration/classificationbyCNN/mirex_test/folder/pop.00017.au	pop
G:/PycharmProjects/musicgeneration/classificationbyCNN/mirex_test/folder/blues.00080.au	blues
G:/PycharmProjects/musicgeneration/classificationbyCNN/mirex_test/folder/rock.00030.au	rock
G:/PycharmProjects/musicgeneration/classificationbyCNN/mirex_test/folder/hiphop.00001.au	hiphop
G:/PycharmProjects/musicgeneration/classificationbyCNN/mirex_test/folder/jazz.00007.au	jazz
G:/PycharmProjects/musicgeneration/classificationbyCNN/mirex_test/folder/rock.00041.au	rock
G:/PycharmProjects/musicgeneration/classificationbyCNN/mirex_test/folder/pop.00092.au	pop
G:/PycharmProjects/musicgeneration/classificationbyCNN/mirex_test/folder/metal.00040.au	metal
G:/PycharmProjects/musicgeneration/classificationbyCNN/mirex_test/folder/rock.00036.au	rock
G:/PycharmProjects/musicgeneration/classificationbyCNN/mirex_test/folder/country.00081.au	country
G:/PycharmProjects/musicgeneration/classificationbyCNN/mirex_test/folder/jazz.00054.au	jazz
G:/PycharmProjects/musicgeneration/classificationbyCNN/mirex_test/folder/country.00030.au	country
G:/PycharmProjects/musicgeneration/classificationbyCNN/mirex_test/folder/hiphop.00082.au	hiphop
G:/PycharmProjects/musicgeneration/classificationbyCNN/mirex_test/folder/classical.00079.au	classical
G:/PycharmProjects/musicgeneration/classificationbyCNN/mirex_test/folder/rock.00082.au	rock
G:/PycharmProjects/musicgeneration/classificationbyCNN/mirex_test/folder/country.00055.au	country
G:/PycharmProjects/musicgeneration/classificationbyCNN/mirex_test/folder/pop.00067.au	pop
G:/PycharmProjects/musicgeneration/classificationbyCNN/mirex_test/folder/metal.00062.au	metal
G:/PycharmProjects/musicgeneration/classificationbyCNN/mirex_test/folder/disco.00041.au	disco
G:/PycharmProjects/musicgeneration/classificationbyCNN/mirex_test/folder/country.00080.au	country
G:/PycharmProjects/musicgeneration/classificationbyCNN/mirex_test/folder/blues.00057.au	blues
G:/PycharmProjects/musicgeneration/classificationbyCNN/mirex_test/folder/jazz.00061.au	jazz
G:/PycharmProjects/musicgeneration/classificationbyCNN/mirex_test/folder/metal.00048.au	metal
G:/PycharmProjects/musicgeneration/classificationbyCNN/mirex_test/folder/rock.00048.au	rock
G:/PycharmProjects/musicgeneration/classificationbyCNN/mirex_test/folder/blues.00099.au	blues
G:/PycharmProjects/musicgeneration/classificationbyCNN/mirex_test/folder/blues.00074.au	blues
G:/PycharmProjects/musicgeneration/classificationbyCNN/mirex_test/folder/hiphop.00097.au	hiphop
G:/PycharmProjects/musicgeneration/classificationbyCNN/mirex_test/folder/classical.00084.au	classical
G:/PycharmProjects/musicgeneration/classificationbyCNN/mirex_test/folder/rock.00077.au	rock
G:/PycharmProjects/musicgeneration/classificationbyCNN/mirex_test/folder/reggae.00085.au	reggae
G:/PycharmProjects/musicgeneration/classificationbyCNN/mirex_test/folder/pop.00037.au	pop
G:/PycharmProjects/musicgeneration/classificationbyCNN/mirex_test/folder/metal.00003.au	metal
G:/PycharmProjects/musicgeneration/classificationbyCNN/mirex_test/folder/reggae.00014.au	reggae
G:/PycharmProjects/musicgeneration/classificationbyCNN/mirex_test/folder/pop.00007.au	pop
G:/PycharmProjects/musicgeneration/classificationbyCNN/mirex_test/folder/rock.00093.au	rock
G:/PycharmProjects/musicgeneration/classificationbyCNN/mirex_test/folder/pop.00024.au	pop
G:/PycharmProjects/musicgeneration/classificationbyCNN/mirex_test/folder/classical.00006.au	classical
G:/PycharmProjects/musicgeneration/classificationbyCNN/mirex_test/folder/hiphop.00085.au	hiphop
G:/PycharmProjects/musicgeneration/classificationbyCNN/mirex_test/folder/disco.00035.au	disco
G:/PycharmProjects/musicgeneration/classificationbyCNN/mirex_test/folder/jazz.00089.au	jazz
G:/PycharmProjects/musicgeneration/classificationbyCNN/mirex_test/folder/blues.00046.au	blues
G:/PycharmProjects/musicgeneration/classificationbyCNN/mirex_test/folder/hiphop.00046.au	hiphop
G:/PycharmProjects/musicgeneration/classificationbyCNN/mirex_test/folder/disco.00020.au	disco
G:/PycharmProjects/musicgeneration/classificationbyCNN/mirex_test/folder/metal.00004.au	metal
G:/PycharmProjects/musicgeneration/classificationbyCNN/mirex_test/folder/reggae.00039.au	reggae
G:/PycharmProjects/musicgeneration/classificationbyCNN/mirex_test/folder/disco.00089.au	disco
G:/PycharmProjects/musicgeneration/classificationbyCNN/mirex_test/folder/rock.00085.au	rock
G:/PycharmProjects/musicgeneration/classificationbyCNN/mirex_test/folder/classical.00098.au	classical
G:/PycharmProjects/musicgeneration/classificationbyCNN/mirex_test/folder/classical.00039.au	classical
G:/PycharmProjects/musicgeneration/classificationbyCNN/mirex_test/folder/hiphop.00063.au	hiphop
G:/PycharmProjects/musicgeneration/classificationbyCNN/mirex_test/folder/hiphop.00094.au	hiphop
G:/PycharmProjects/musicgeneration/classificationbyCNN/mirex_test/folder/classical.00033.au	classical
G:/PycharmProjects/musicgeneration/classificationbyCNN/mirex_test/folder/rock.00087.au	rock
G:/PycharmProjects/musicgeneration/classificationbyCNN/mirex_test/folder/classical.00034.au	classical
G:/PycharmProjects/musicgeneration/classificationbyCNN/mirex_test/folder/reggae.00023.au	reggae
G:/PycharmProjects/musicgeneration/classificationbyCNN/mirex_test/folder/disco.00083.au	disco
G:/PycharmProjects/musicgeneration/classificationbyCNN/mirex_test/folder/pop.00066.au	pop
G:/PycharmProjects/musicgeneration/classificationbyCNN/mirex_test/folder/country.00082.au	country
G:/PycharmProjects/musicgeneration/classificationbyCNN/mirex_test/folder/metal.00097.au	metal
G:/PycharmProjects/musicgeneration/classificationbyCNN/mirex_test/folder/country.00016.au	country
G:/PycharmProjects/musicgeneration/classificationbyCNN/mirex_test/folder/rock.00002.au	rock
G:/PycharmProjects/musicgeneration/classificationbyCNN/mirex_test/folder/classical.00087.au	classical
G:/PycharmProjects/musicgeneration/classificationbyCNN/mirex_test/folder/jazz.00006.au	jazz
G:/PycharmProjects/musicgeneration/classificationbyCNN/mirex_test/folder/reggae.00050.au	reggae
G:/PycharmProjects/musicgeneration/classificationbyCNN/mirex_test/folder/hiphop.00027.au	hiphop
G:/PycharmProjects/musicgeneration/classificationbyCNN/mirex_test/folder/blues.00019.au	blues
G:/PycharmProjects/musicgeneration/classificationbyCNN/mirex_test/folder/reggae.00042.au	reggae
G:/PycharmProjects/musicgeneration/classificationbyCNN/mirex_test/folder/jazz.00036.au	jazz
G:/PycharmProjects/musicgeneration/classificationbyCNN/mirex_test/folder/reggae.00071.au	reggae
G:/PycharmProjects/musicgeneration/classificationbyCNN/mirex_test/folder/hiphop.00093.au	hiphop
G:/PycharmProjects/musicgeneration/classificationbyCNN/mirex_test/folder/country.00010.au	country
G:/PycharmProjects/musicgeneration/classificationbyCNN/mirex_test/folder/disco.00071.au	disco
G:/PycharmProjects/musicgeneration/classificationbyCNN/mirex_test/folder/classical.00056.au	classical
G:/PycharmProjects/musicgeneration/classificationbyCNN/mirex_test/folder/classical.00027.au	classical
G:/PycharmProjects/musicgeneration/classificationbyCNN/mirex_test/folder/metal.00081.au	metal
G:/PycharmProjects/musicgeneration/classificationbyCNN/mirex_test/folder/pop.00079.au	pop
G:/PycharmProjects/musicgeneration/classificationbyCNN/mirex_test/folder/rock.00095.au	rock
G:/PycharmProjects/musicgeneration/classificationbyCNN/mirex_test/folder/hiphop.00084.au	hiphop
G:/PycharmProjects/musicgeneration/classificationbyCNN/mirex_test/folder/classical.00025.au	classical
G:/PycharmProjects/musicgeneration/classificationbyCNN/mirex_test/folder/pop.00050.au	pop
G:/PycharmProjects/musicgeneration/classificationbyCNN/mirex_test/folder/metal.00021.au	metal
G:/PycharmProjects/musicgeneration/classificationbyCNN/mirex_test/folder/reggae.00063.au	reggae
G:/PycharmProjects/musicgeneration/classificationbyCNN/mirex_test/folder/blues.00076.au	blues
G:/PycharmProjects/musicgeneration/classificationbyCNN/mirex_test/folder/disco.00001.au	disco
G:/PycharmProjects/musicgeneration/classificationbyCNN/mirex_test/folder/metal.00078.au	metal
G:/PycharmProjects/musicgeneration/classificationbyCNN/mirex_test/folder/pop.00051.au	pop
G:/PycharmProjects/musicgeneration/classificationbyCNN/mirex_test/folder/metal.00020.au	metal
G:/PycharmProjects/musicgeneration/classificationbyCNN/mirex_test/folder/pop.00013.au	pop
G:/PycharmProjects/musicgeneration/classificationbyCNN/mirex_test/folder/classical.00051.au	classical
G:/PycharmProjects/musicgeneration/classificationbyCNN/mirex_test/folder/rock.00049.au	rock
G:/PycharmProjects/musicgeneration/classificationbyCNN/mirex_test/folder/rock.00001.au	rock
G:/PycharmProjects/musicgeneration/classificationbyCNN/mirex_test/folder/disco.00066.au	disco
G:/PycharmProjects/musicgeneration/classificationbyCNN/mirex_test/folder/blues.00010.au	blues
G:/PycharmProjects/musicgeneration/classificationbyCNN/mirex_test/folder/country.00036.au	country
G:/PycharmProjects/musicgeneration/classificationbyCNN/mirex_test/folder/hiphop.00017.au	hiphop
G:/PycharmProjects/musicgeneration/classificationbyCNN/mirex_test/folder/jazz.00065.au	jazz
G:/PycharmProjects/musicgeneration/classificationbyCNN/mirex_test/folder/metal.00006.au	metal
G:/PycharmProjects/musicgeneration/classificationbyCNN/mirex_test/folder/rock.00029.au	rock
G:/PycharmProjects/musicgeneration/classificationbyCNN/mirex_test/folder/disco.00088.au	disco
G:/PycharmProjects/musicgeneration/classificationbyCNN/mirex_test/folder/country.00003.au	country
G:/PycharmProjects/musicgeneration/classificationbyCNN/mirex_test/folder/classical.00059.au	classical
G:/PycharmProjects/musicgeneration/classificationbyCNN/mirex_test/folder/disco.00086.au	disco
G:/PycharmProjects/musicgeneration/classificationbyCNN/mirex_test/folder/disco.00096.au	disco
G:/PycharmProjects/musicgeneration/classificationbyCNN/mirex_test/folder/hiphop.00072.au	hiphop
G:/PycharmProjects/musicgeneration/classificationbyCNN/mirex_test/folder/hiphop.00064.au	hiphop
G:/PycharmProjects/musicgeneration/classificationbyCNN/mirex_test/folder/hiphop.00013.au	hiphop
G:/PycharmProjects/musicgeneration/classificationbyCNN/mirex_test/folder/pop.00026.au	pop
G:/PycharmProjects/musicgeneration/classificationbyCNN/mirex_test/folder/blues.00065.au	blues
G:/PycharmProjects/musicgeneration/classificationbyCNN/mirex_test/folder/metal.00070.au	metal
G:/PycharmProjects/musicgeneration/classificationbyCNN/mirex_test/folder/classical.00068.au	classical
G:/PycharmProjects/musicgeneration/classificationbyCNN/mirex_test/folder/hiphop.00019.au	hiphop
G:/PycharmProjects/musicgeneration/classificationbyCNN/mirex_test/folder/hiphop.00006.au	hiphop
G:/PycharmProjects/musicgeneration/classificationbyCNN/mirex_test/folder/jazz.00034.au	jazz
G:/PycharmProjects/musicgeneration/classificationbyCNN/mirex_test/folder/pop.00077.au	pop
G:/PycharmProjects/musicgeneration/classificationbyCNN/mirex_test/folder/rock.00088.au	rock
G:/PycharmProjects/musicgeneration/classificationbyCNN/mirex_test/folder/metal.00015.au	metal
G:/PycharmProjects/musicgeneration/classificationbyCNN/mirex_test/folder/pop.00057.au	pop
G:/PycharmProjects/musicgeneration/classificationbyCNN/mirex_test/folder/rock.00076.au	rock
G:/PycharmProjects/musicgeneration/classificationbyCNN/mirex_test/folder/pop.00096.au	pop
G:/PycharmProjects/musicgeneration/classificationbyCNN/mirex_test/folder/disco.00092.au	disco
G:/PycharmProjects/musicgeneration/classificationbyCNN/mirex_test/folder/classical.00043.au	classical
G:/PycharmProjects/musicgeneration/classificationbyCNN/mirex_test/folder/pop.00073.au	pop
G:/PycharmProjects/musicgeneration/classificationbyCNN/mirex_test/folder/jazz.00009.au	jazz
G:/PycharmProjects/musicgeneration/classificationbyCNN/mirex_test/folder/jazz.00050.au	jazz
G:/PycharmProjects/musicgeneration/classificationbyCNN/mirex_test/folder/disco.00011.au	disco
G:/PycharmProjects/musicgeneration/classificationbyCNN/mirex_test/folder/blues.00037.au	blues
G:/PycharmProjects/musicgeneration/classificationbyCNN/mirex_test/folder/disco.00003.au	disco
G:/PycharmProjects/musicgeneration/classificationbyCNN/mirex_test/folder/rock.00038.au	rock
G:/PycharmProjects/musicgeneration/classificationbyCNN/mirex_test/folder/hiphop.00003.au	hiphop
G:/PycharmProjects/musicgeneration/classificationbyCNN/mirex_test/folder/disco.00065.au	disco
G:/PycharmProjects/musicgeneration/classificationbyCNN/mirex_test/folder/classical.00038.au	classical
G:/PycharmProjects/musicgeneration/classificationbyCNN/mirex_test/folder/pop.00041.au	pop
G:/PycharmProjects/musicgeneration/classificationbyCNN/mirex_test/folder/reggae.00001.au	reggae
G:/PycharmProjects/musicgeneration/classificationbyCNN/mirex_test/folder/country.00033.au	country
G:/PycharmProjects/musicgeneration/classificationbyCNN/mirex_test/folder/hiphop.00035.au	hiphop
G:/PycharmProjects/musicgeneration/classificationbyCNN/mirex_test/folder/pop.00022.au	pop
G:/PycharmProjects/musicgeneration/classificationbyCNN/mirex_test/folder/hiphop.00067.au	hiphop
G:/PycharmProjects/musicgeneration/classificationbyCNN/mirex_test/folder/reggae.00017.au	reggae
G:/PycharmProjects/musicgeneration/classificationbyCNN/mirex_test/folder/jazz.00094.au	jazz
G:/PycharmProjects/musicgeneration/classificationbyCNN/mirex_test/folder/blues.00006.au	blues
G:/PycharmProjects/musicgeneration/classificationbyCNN/mirex_test/folder/blues.00003.au	blues
G:/PycharmProjects/musicgeneration/classificationbyCNN/mirex_test/folder/rock.00070.au	rock
G:/PycharmProjects/musicgeneration/classificationbyCNN/mirex_test/folder/pop.00035.au	pop
G:/PycharmProjects/musicgeneration/classificationbyCNN/mirex_test/folder/country.00096.au	country
G:/PycharmProjects/musicgeneration/classificationbyCNN/mirex_test/folder/classical.00077.au	classical
G:/PycharmProjects/musicgeneration/classificationbyCNN/mirex_test/folder/country.00051.au	country
G:/PycharmProjects/musicgeneration/classificationbyCNN/mirex_test/folder/classical.00054.au	classical
G:/PycharmProjects/musicgeneration/classificationbyCNN/mirex_test/folder/hiphop.00031.au	hiphop
G:/PycharmProjects/musicgeneration/classificationbyCNN/mirex_test/folder/rock.00083.au	rock
G:/PycharmProjects/musicgeneration/classificationbyCNN/mirex_test/folder/classical.00010.au	classical
G:/PycharmProjects/musicgeneration/classificationbyCNN/mirex_test/folder/country.00049.au	country
G:/PycharmProjects/musicgeneration/classificationbyCNN/mirex_test/folder/metal.00068.au	metal
G:/PycharmProjects/musicgeneration/classificationbyCNN/mirex_test/folder/rock.00017.au	rock
G:/PycharmProjects/musicgeneration/classificationbyCNN/mirex_test/folder/country.00062.au	country
G:/PycharmProjects/musicgeneration/classificationbyCNN/mirex_test/folder/hiphop.00028.au	hiphop
G:/PycharmProjects/musicgeneration/classificationbyCNN/mirex_test/folder/jazz.00011.au	jazz
G:/PycharmProjects/musicgeneration/classificationbyCNN/mirex_test/folder/disco.00000.au	disco
G:/PycharmProjects/musicgeneration/classificationbyCNN/mirex_test/folder/reggae.00022.au	reggae
G:/PycharmProjects/musicgeneration/classificationbyCNN/mirex_test/folder/blues.00053.au	blues
G:/PycharmProjects/musicgeneration/classificationbyCNN/mirex_test/folder/metal.00037.au	metal
G:/PycharmProjects/musicgeneration/classificationbyCNN/mirex_test/folder/disco.00038.au	disco
G:/PycharmProjects/musicgeneration/classificationbyCNN/mirex_test/folder/classical.00005.au	classical
G:/PycharmProjects/musicgeneration/classificationbyCNN/mirex_test/folder/jazz.00068.au	jazz
G:/PycharmProjects/musicgeneration/classificationbyCNN/mirex_test/folder/metal.00096.au	metal
G:/PycharmProjects/musicgeneration/classificationbyCNN/mirex_test/folder/pop.00031.au	pop
G:/PycharmProjects/musicgeneration/classificationbyCNN/mirex_test/folder/rock.00062.au	rock
G:/PycharmProjects/musicgeneration/classificationbyCNN/mirex_test/folder/blues.00094.au	blues
G:/PycharmProjects/musicgeneration/classificationbyCNN/mirex_test/folder/jazz.00085.au	jazz
G:/PycharmProjects/musicgeneration/classificationbyCNN/mirex_test/folder/jazz.00059.au	jazz
G:/PycharmProjects/musicgeneration/classificationbyCNN/mirex_test/folder/pop.00059.au	pop
G:/PycharmProjects/musicgeneration/classificationbyCNN/mirex_test/folder/rock.00055.au	rock
G:/PycharmProjects/musicgeneration/classificationbyCNN/mirex_test/folder/reggae.00096.au	reggae
G:/PycharmProjects/musicgeneration/classificationbyCNN/mirex_test/folder/blues.00018.au	blues
G:/PycharmProjects/musicgeneration/classificationbyCNN/mirex_test/folder/classical.00070.au	classical
G:/PycharmProjects/musicgeneration/classificationbyCNN/mirex_test/folder/metal.00060.au	metal
G:/PycharmProjects/musicgeneration/classificationbyCNN/mirex_test/folder/pop.00074.au	pop
G:/PycharmProjects/musicgeneration/classificationbyCNN/mirex_test/folder/classical.00080.au	classical
G:/PycharmProjects/musicgeneration/classificationbyCNN/mirex_test/folder/rock.00033.au	rock
G:/PycharmProjects/musicgeneration/classificationbyCNN/mirex_test/folder/metal.00077.au	metal
G:/PycharmProjects/musicgeneration/classificationbyCNN/mirex_test/folder/jazz.00072.au	jazz
G:/PycharmProjects/musicgeneration/classificationbyCNN/mirex_test/folder/reggae.00045.au	reggae
G:/PycharmProjects/musicgeneration/classificationbyCNN/mirex_test/folder/disco.00045.au	disco
G:/PycharmProjects/musicgeneration/classificationbyCNN/mirex_test/folder/reggae.00097.au	reggae
G:/PycharmProjects/musicgeneration/classificationbyCNN/mirex_test/folder/rock.00018.au	rock
G:/PycharmProjects/musicgeneration/classificationbyCNN/mirex_test/folder/hiphop.00014.au	hiphop
G:/PycharmProjects/musicgeneration/classificationbyCNN/mirex_test/folder/classical.00037.au	classical
G:/PycharmProjects/musicgeneration/classificationbyCNN/mirex_test/folder/country.00031.au	country
G:/PycharmProjects/musicgeneration/classificationbyCNN/mirex_test/folder/blues.00041.au	blues
G:/PycharmProjects/musicgeneration/classificationbyCNN/mirex_test/folder/hiphop.00016.au	hiphop
G:/PycharmProjects/musicgeneration/classificationbyCNN/mirex_test/folder/classical.00032.au	classical
G:/PycharmProjects/musicgeneration/classificationbyCNN/mirex_test/folder/reggae.00044.au	reggae
G:/PycharmProjects/musicgeneration/classificationbyCNN/mirex_test/folder/classical.00083.au	classical
G:/PycharmProjects/musicgeneration/classificationbyCNN/mirex_test/folder/reggae.00072.au	reggae
G:/PycharmProjects/musicgeneration/classificationbyCNN/mirex_test/folder/jazz.00071.au	jazz
G:/PycharmProjects/musicgeneration/classificationbyCNN/mirex_test/folder/country.00029.au	country
G:/PycharmProjects/musicgeneration/classificationbyCNN/mirex_test/folder/rock.00054.au	rock
G:/PycharmProjects/musicgeneration/classificationbyCNN/mirex_test/folder/pop.00049.au	pop
G:/PycharmProjects/musicgeneration/classificationbyCNN/mirex_test/folder/metal.00080.au	metal
G:/PycharmProjects/musicgeneration/classificationbyCNN/mirex_test/folder/pop.00085.au	pop
G:/PycharmProjects/musicgeneration/classificationbyCNN/mirex_test/folder/metal.00072.au	metal
G:/PycharmProjects/musicgeneration/classificationbyCNN/mirex_test/folder/jazz.00079.au	jazz
G:/PycharmProjects/musicgeneration/classificationbyCNN/mirex_test/folder/reggae.00012.au	reggae
G:/PycharmProjects/musicgeneration/classificationbyCNN/mirex_test/folder/reggae.00024.au	reggae
G:/PycharmProjects/musicgeneration/classificationbyCNN/mirex_test/folder/jazz.00080.au	jazz
G:/PycharmProjects/musicgeneration/classificationbyCNN/mirex_test/folder/pop.00060.au	pop
G:/PycharmProjects/musicgeneration/classificationbyCNN/mirex_test/folder/disco.00007.au	disco
G:/PycharmProjects/musicgeneration/classificationbyCNN/mirex_test/folder/country.00042.au	country
G:/PycharmProjects/musicgeneration/classificationbyCNN/mirex_test/folder/hiphop.00078.au	hiphop
G:/PycharmProjects/musicgeneration/classificationbyCNN/mirex_test/folder/hiphop.00024.au	hiphop
G:/PycharmProjects/musicgeneration/classificationbyCNN/mirex_test/folder/country.00083.au	country
G:/PycharmProjects/musicgeneration/classificationbyCNN/mirex_test/folder/jazz.00016.au	jazz
G:/PycharmProjects/musicgeneration/classificationbyCNN/mirex_test/folder/blues.00042.au	blues
G:/PycharmProjects/musicgeneration/classificationbyCNN/mirex_test/folder/blues.00011.au	blues
G:/PycharmProjects/musicgeneration/classificationbyCNN/mirex_test/folder/pop.00047.au	pop
G:/PycharmProjects/musicgeneration/classificationbyCNN/mirex_test/folder/reggae.00054.au	reggae
G:/PycharmProjects/musicgeneration/classificationbyCNN/mirex_test/folder/classical.00099.au	classical
G:/PycharmProjects/musicgeneration/classificationbyCNN/mirex_test/folder/hiphop.00061.au	hiphop
G:/PycharmProjects/musicgeneration/classificationbyCNN/mirex_test/folder/hiphop.00059.au	hiphop
G:/PycharmProjects/musicgeneration/classificationbyCNN/mirex_test/folder/classical.00081.au	classical
G:/PycharmProjects/musicgeneration/classificationbyCNN/mirex_test/folder/metal.00079.au	metal
G:/PycharmProjects/musicgeneration/classificationbyCNN/mirex_test/folder/reggae.00098.au	reggae
G:/PycharmProjects/musicgeneration/classificationbyCNN/mirex_test/folder/metal.00025.au	metal
G:/PycharmProjects/musicgeneration/classificationbyCNN/mirex_test/folder/hiphop.00045.au	hiphop
G:/PycharmProjects/musicgeneration/classificationbyCNN/mirex_test/folder/jazz.00046.au	jazz
G:/PycharmProjects/musicgeneration/classificationbyCNN/mirex_test/folder/disco.00046.au	disco
G:/PycharmProjects/musicgeneration/classificationbyCNN/mirex_test/folder/classical.00060.au	classical
G:/PycharmProjects/musicgeneration/classificationbyCNN/mirex_test/folder/rock.00023.au	rock
G:/PycharmProjects/musicgeneration/classificationbyCNN/mirex_test/folder/metal.00044.au	metal
G:/PycharmProjects/musicgeneration/classificationbyCNN/mirex_test/folder/disco.00026.au	disco
G:/PycharmProjects/musicgeneration/classificationbyCNN/mirex_test/folder/blues.00035.au	blues
G:/PycharmProjects/musicgeneration/classificationbyCNN/mirex_test/folder/country.00063.au	country
G:/PycharmProjects/musicgeneration/classificationbyCNN/mirex_test/folder/disco.00005.au	disco
G:/PycharmProjects/musicgeneration/classificationbyCNN/mirex_test/folder/disco.00018.au	disco
G:/PycharmProjects/musicgeneration/classificationbyCNN/mirex_test/folder/blues.00072.au	blues
G:/PycharmProjects/musicgeneration/classificationbyCNN/mirex_test/folder/classical.00082.au	classical
G:/PycharmProjects/musicgeneration/classificationbyCNN/mirex_test/folder/classical.00029.au	classical
G:/PycharmProjects/musicgeneration/classificationbyCNN/mirex_test/folder/jazz.00086.au	jazz
G:/PycharmProjects/musicgeneration/classificationbyCNN/mirex_test/folder/hiphop.00081.au	hiphop
G:/PycharmProjects/musicgeneration/classificationbyCNN/mirex_test/folder/jazz.00041.au	jazz
G:/PycharmProjects/musicgeneration/classificationbyCNN/mirex_test/folder/rock.00074.au	rock
G:/PycharmProjects/musicgeneration/classificationbyCNN/mirex_test/folder/pop.00055.au	pop
G:/PycharmProjects/musicgeneration/classificationbyCNN/mirex_test/folder/pop.00069.au	pop
G:/PycharmProjects/musicgeneration/classificationbyCNN/mirex_test/folder/reggae.00026.au	reggae
G:/PycharmProjects/musicgeneration/classificationbyCNN/mirex_test/folder/metal.00085.au	metal
G:/PycharmProjects/musicgeneration/classificationbyCNN/mirex_test/folder/metal.00000.au	metal
G:/PycharmProjects/musicgeneration/classificationbyCNN/mirex_test/folder/reggae.00041.au	reggae
G:/PycharmProjects/musicgeneration/classificationbyCNN/mirex_test/folder/country.00076.au	country
G:/PycharmProjects/musicgeneration/classificationbyCNN/mirex_test/folder/metal.00045.au	metal
G:/PycharmProjects/musicgeneration/classificationbyCNN/mirex_test/folder/hiphop.00047.au	hiphop
G:/PycharmProjects/musicgeneration/classificationbyCNN/mirex_test/folder/jazz.00047.au	jazz
G:/PycharmProjects/musicgeneration/classificationbyCNN/mirex_test/folder/metal.00074.au	metal
G:/PycharmProjects/musicgeneration/classificationbyCNN/mirex_test/folder/metal.00056.au	metal
G:/PycharmProjects/musicgeneration/classificationbyCNN/mirex_test/folder/metal.00094.au	metal
G:/PycharmProjects/musicgeneration/classificationbyCNN/mirex_test/folder/rock.00005.au	rock
G:/PycharmProjects/musicgeneration/classificationbyCNN/mirex_test/folder/pop.00039.au	pop
G:/PycharmProjects/musicgeneration/classificationbyCNN/mirex_test/folder/disco.00078.au	disco
G:/PycharmProjects/musicgeneration/classificationbyCNN/mirex_test/folder/metal.00046.au	metal
G:/PycharmProjects/musicgeneration/classificationbyCNN/mirex_test/folder/country.00020.au	country
